# 文件名：K人物词表.scel
# 词库名：K人物词表
# 词库分类：新番
# 词库描述：
# 词条样例：镰本力夫 十束多多良 宗像礼司 淡岛世理 榎本竜哉 五岛莲
# 词条数量：22

八田美咲	ba tian mei xiao	16
弁财酉次郎	bian cai you ci lang	9
布施大辉	bu shi da hui	5
草薙出云	cao ti chu yun	17
淡岛世理	dan dao shi li	11
道明寺安迪	dao ming si an di	7
伏见猿比古	fu jian yuan bi gu	12
国常路大觉	guo chang lu da jiao	2
榎本竜哉	jia ben long zai	6
加茂刘芳	jia mao liu fang	8
镰本力夫	lian ben li fu	15
秋山氷杜	qiu shan bing du	10
日高晓	ri gao xiao	3
三轮一言	san lun yi yan	1
十束多多良	shi shu duo duo liang	14
五岛莲	wu dao lian	4
雪染菊理	xue ran ju li	20
夜刀神狗朗	ye dao shen gou lang	21
伊佐那社	yi zuo na she	22
栉名安娜	zhi ming an na	18
周防尊	zhou fang zun	19
宗像礼司	zong xiang li si	13
