# 文件名：全名TV.scel
# 词库名：全名TV
# 词库分类：其它
# 词库描述：
# 词条样例：你的身材无与伦比 对跳舞也很给力 这波非常稳 房管都被榨干了 跳个舞吧
# 词条数量：16

除了直播日常都喜欢干什么呢	chu le zhi bo ri chang dou xi huan gan shen me ne	14
对跳舞也很给力	dui tiao wu ye hen gei li	12
多一点真诚少一点儿套路	duo yi dian zhen cheng shao yi dian er tao lu	2
房管不要污的哦	fang guan bu yao wu de o	1
房管都被榨干了	fang guan dou bei zha gan le	4
今天出什么东西了	jin tian chu shen me dong xi le	6
老铁你这个太扎心	lao tie ni zhe ge tai zha xin	7
老铁这波	lao tie zhe bo	8
那你就多喝点水吧	na ni jiu duo he dian shui ba	16
你的身材无与伦比	ni de shen cai wu yu lun bi	11
跳个舞吧	tiao ge wu ba	13
为什么衣服一直掉呢	wei shen me yi fu yi zhi diao ne	15
我们来吹牛吧	wo men lai chui niu ba	9
兄弟可以哦	xiong di ke yi o	5
这波非常稳	zhe bo fei chang wen	3
主播你直播到几点	zhu bo ni zhi bo dao ji dian	10
