# 文件名：名侦探柯南各集名称.scel
# 词库名：名侦探柯南各集名称
# 词库分类：名侦探柯南
# 词库描述：
# 词条样例：大都会暗号地图藏宝事件 天下第一夜祭杀人事件 足球选手恐吓事件 步美被绑事件 谜样的讯息狙击事件 消失的尸体杀人事件
# 词条数量：349

爱犬约翰杀人事件	ai quan yue han sha ren shi jian	325
爱与决心的必杀球	ai yu jue xin de bi sha qiu	148
爱与幽灵和地球遗产	ai yu you ling he di qiu yi chan	119
八头蛇的剑	ba tou she de jian	82
白鹤报恩杀人事件	bai he bao en sha ren shi jian	275
百货公司挟持事件	bai huo gong si xie chi shi jian	333
白色海滩杀人事件	bai se hai tan sha ren shi jian	257
包房的死角	bao fang de si jiao	12
宝石抢匪现行犯	bao shi qiang fei xian xing fan	92
被钢铁构架阻挡的男子	bei gang tie gou jia zu dang de nan zi	66
被狙击的名侦探	bei ju ji de ming zhen tan	211
被杀了四次的男人	bei sha le si ci de nan ren	218
被挑拨的友情	bei tiao bo de you qing	130
被遗忘的手机	bei yi wang de shou ji	118
被组织的魔掌触碰的瞬间	bei zu zhi de mo zhang chu peng de shun jian	78
本厅刑警的恋爱故事	ben ting xing jing de lian ai gu shi	61
本厅刑警的恋爱故事左手无名指	ben ting xing jing de lian ai gu shi zuo shou wu ming zhi	32
本厅刑事的恋爱物语	ben ting xing shi de lian ai wu yu	236
便利店的陷阱	bian li dian de xian jing	122
别有玄机的八音盒	bie you xuan ji de ba yin he	203
不可思议的春天甲壳虫	bu ke si yi de chun tian jia ke chong	113
不可思议的天使之馆	bu ke si yi de tian shi zhi guan	91
步美被绑事件	bu mei bei bang shi jian	338
步美传达的讯息	bu mei chuan da de xun xi	240
不能控制的租赁汽车	bu neng kong zhi de zu lin qi che	44
不在场证明的隐身术	bu zai chang zheng ming de yin shen shu	135
不在场证明杀人事件	bu zai chang zheng ming sha ren shi jian	322
厕所里隐藏的秘密	ce suo li yin cang de mi mi	124
插画画家杀人事件	cha hua hua jia sha ren shi jian	296
缠在网子中的谜团	chan zai wang zi zhong de mi tuan	174
超级汽车陷阱	chao ji qi che xian jing	201
超秘密的上学路	chao mi mi de shang xue lu	76
朝向迷宫的入口巨神像之怒	chao xiang mi gong de ru kou ju shen xiang zhi nu	196
沉没的航线	chen mo de hang xian	106
沉默的环状线	chen mo de huan zhuang xian	229
池塘边的奇怪事件	chi tang bian de qi guai shi jian	46
持有疑惑的小兰	chi you yi huo de xiao lan	93
充满杀意的咖啡香	chong man sha yi de ka fei xiang	8
初恋情人回忆事件	chu lian qing ren hui yi shi jian	265
从右向左招财猫	cong you xiang zuo zhao cai mao	33
大阪事件	da ban shi jian	179
大都会暗号地图藏宝事件	da du hui an hao di tu cang bao shi jian	346
大怪兽哥斯拉杀人事件	da guai shou ge si la sha ren shi jian	294
大学教授杀人事件	da xue jiao shou sha ren shi jian	246
大作战	da zuo zhan	53
当红歌星绑架事件	dang hong ge xing bang jia shi jian	279
德休拉别墅杀人事件	de xiu la bie shu sha ren shi jian	274
帝丹高中的学校怪谈	di dan gao zhong de xue xiao guai tan	29
帝丹高中的学校怪谈前篇	di dan gao zhong de xue xiao guai tan qian pian	30
帝丹小学七大离奇事件	di dan xiao xue qi da li qi shi jian	258
第九个门大搜查	di jiu ge men da sou cha	214
第三个选择	di san ge xuan ze	207
第三个指纹杀人事件	di san ge zhi wen sha ren shi jian	293
地上电车紧急煞车事件	di shang dian che jin ji sha che shi jian	235
第十个乘客	di shi ge cheng ke	199
第一次购物杀人事件	di yi ci gou wu sha ren shi jian	297
颠倒的场景	dian dao de chang jing	57
电视台的恶魔	dian shi tai de e mo	31
电视台杀人事件	dian shi tai sha ren shi jian	321
电视台外景队杀人事件	dian shi tai wai jing dui sha ren shi jian	329
电梯杀人事件	dian ti sha ren shi jian	331
电玩公司杀人事件	dian wan gong si sha ren shi jian	301
玷污的假面英雄	dian wu de jia mian ying xiong	137
钓鱼大会的悲剧	diao yu da hui de bei ju	117
东京现影所的秘密	dong jing xian ying suo de mi mi	127
洞窟内的侦探团	dong ku nei de zhen tan tuan	209
董事长千金诱拐事件	dong shi zhang qian jin you guai shi jian	348
都市的乌鸦	du shi de wu ya	112
俄罗斯蓝猫的秘密	e luo si lan mao de mi mi	64
恶意与胜者的行进	e yi yu sheng zhe de xing jin	145
恶运大奖	e yun da jiang	41
法庭上的对决	fa ting shang de dui jue	163
犯罪的遗物	fan zui de yi wu	161
非常奇怪的天谴	fei chang qi guai de tian qian	168
飞机空中密室	fei ji kong zhong mi shi	226
妃英理律师之恋	fei ying li lv shi zhi lian	42
风林火山迷宫的铠甲武士	feng lin huo shan mi gong de kai jia wu shi	6
风林火山阴影和雷光的对决	feng lin huo shan yin ying he lei guang de dui jue	5
封印的欧式窗	feng yin de ou shi chuang	63
佛灭前出现的恶灵	fo mie qian chu xian de e ling	84
服部平次一筹莫展	fu bu ping ci yi chou mo zhan	133
福尔摩斯诡异的杀人事件	fu er mo si gui yi de sha ren shi jian	298
富豪家族连续惨死事件	fu hao jia zu lian xu can si shi jian	282
复活的死亡讯息	fu huo de si wang xun xi	220
敷面膜杀人事件	fu mian mo sha ren shi jian	309
负伤之下的名侦探	fu shang zhi xia de ming zhen tan	208
钢琴奏鸣曲月光杀人事件	gang qin zou ming qu yue guang sha ren shi jian	339
高尔夫练习场杀人事件	gao er fu lian xi chang sha ren shi jian	304
格斗游戏的陷阱	ge dou you xi de xian jing	186
歌厅杀人事件	ge ting sha ren shi jian	312
给兰的情书	gei lan de qing shu	77
共时性事件	gong shi xing shi jian	111
工藤新一纽约事件	gong teng xin yi niu yue shi jian	151
公寓坠落事件	gong yu zhui luo shi jian	183
孤岛的公主与龙宫城	gu dao de gong zhu yu long gong cheng	149
古董品收藏家杀人事件	gu dong pin shou cang jia sha ren shi jian	334
古装演员杀人事件	gu zhuang yan yuan sha ren shi jian	264
怪盗基德的惊异的空中步行	guai dao ji de de jing yi de kong zhong bu xing	115
怪盗基德的瞬间移动魔术	guai dao ji de de shun jian yi dong mo shu	7
怪盗基德与四幅名画	guai dao ji de yu si fu ming hua	45
怪人循规蹈矩的男人	guai ren xun gui dao ju de nan ren	54
怪屋大冒险	guai wu da mao xian	96
诡计和魔术	gui ji he mo shu	60
诡密的乘客	gui mi de cheng ke	184
鬼婆婆的刀	gui po po de dao	36
鬼屋杀人事件	gui wu sha ren shi jian	330
诡异的五重塔传说	gui yi de wu zhong ta chuan shuo	228
豪华客轮连续杀人事件	hao hua ke lun lian xu sha ren shi jian	328
豪斯登堡的新娘	hao si deng bao de xin niang	123
好运男子的历险	hao yun nan zi de li xian	108
和服部平次一起的三天	he fu bu ping ci yi qi de san tian	38
黑暗之中的死角	hei an zhi zhong de si jiao	221
黑暗组织的影子谜样的高额报酬	hei an zu zhi de ying zi mi yang de gao e bao chou	49
黑暗组织的影子年幼的目击者	hei an zu zhi de ying zi nian you de mu ji zhe	51
黑暗组织的影子奇妙的照明	hei an zu zhi de ying zi qi miao de zhao ming	50
黑暗组织的影子珍珠的流星	hei an zu zhi de ying zi zhen zhu de liu xing	48
黑暗组织抢劫事件	hei an zu zhi qiang jie shi jian	247
黑色照片的去向	hei se zhao pian de qu xiang	34
黑夜的怪男爵杀人事件	hei ye de guai nan jue sha ren shi jian	289
黑衣骑士	hei yi qi shi	206
红白黄色与侦探团	hong bai huang se yu zhen tan tuan	11
红鬼村火祭杀人事件	hong gui cun huo ji sha ren shi jian	315
红酒的告发	hong jiu de gao fa	3
红色的杀机夜想曲	hong se de sha ji ye xiang qu	215
红与黑的碰撞昏睡	hong yu hei de peng zhuang hun shui	23
红与黑的碰撞搅乱	hong yu hei de peng zhuang jiao luan	20
红与黑的碰撞洁白	hong yu hei de peng zhuang jie bai	16
红与黑的碰撞绝叫	hong yu hei de peng zhuang jue jiao	25
红与黑的碰撞决死	hong yu hei de peng zhuang jue si	15
红与黑的碰撞觉醒	hong yu hei de peng zhuang jue xing	21
红与黑的碰撞开端	hong yu hei de peng zhuang kai duan	27
红与黑的碰撞冥土	hong yu hei de peng zhuang ming tu	24
红与黑的碰撞侵入	hong yu hei de peng zhuang qin ru	22
红与黑的碰撞伪装	hong yu hei de peng zhuang wei zhuang	19
红与黑的碰撞嫌疑	hong yu hei de peng zhuang xian yi	17
红与黑的碰撞血缘	hong yu hei de peng zhuang xue yuan	26
红与黑的碰撞殉职	hong yu hei de peng zhuang xun zhi	14
红与黑的碰撞遗言	hong yu hei de peng zhuang yi yan	18
呼叫救护车的男子	hu jiao jiu hu che de nan zi	90
花香杀人事件	hua xiang sha ren shi jian	273
滑雪别墅杀人事件	hua xue bie shu sha ren shi jian	277
黄色不在场证明	huang se bu zai chang zheng ming	37
火焰中的红马	huo yan zhong de hong ma	132
急忙掩饰的忽略	ji mang yan shi de hu lue	160
即时三十分钟	ji shi san shi fen zhong	39
计算机杀人事件	ji suan ji sha ren shi jian	323
极限飞车	ji xian fei che	68
假面超人杀人事件	jia mian chao ren sha ren shi jian	253
坚不可摧的雪人	jian bu ke cui de xue ren	47
健身俱乐部杀人事件	jian shen ju le bu sha ren shi jian	307
江户川柯南被绑事件	jiang hu chuan ke nan bei bang shi jian	311
降雪之夜的恐怖传说	jiang xue zhi ye de kong bu chuan shuo	165
结婚前夕密室事件	jie hun qian xi mi shi shi jian	239
金刀比罗座的怪人	jin dao bi luo zuo de guai ren	59
金融公司社长杀人事件	jin rong gong si she zhang sha ren shi jian	284
警察手册丢失事件	jing cha shou ce diu shi shi jian	157
竞技场无差别胁迫事件	jing ji chang wu cha bie xie po shi jian	245
巨毒蜘蛛的陷阱	ju du zhi zhu de xian jing	105
聚焦侦探团的取材	ju jiao zhen tan tuan de qu cai	72
咖啡厅卡车突然撞入事件	ka fei ting ka che tu ran zhuang ru shi jian	216
咖啡厅杀人事件	ka fei ting sha ren shi jian	320
看不见的嫌疑犯	kan bu jian de xian yi fan	142
看不见的凶器	kan bu jian de xiong qi	202
柯南和怪盗基德	ke nan he guai dao ji de	283
柯南和平次的推理魔术	ke nan he ping ci de tui li mo shu	89
柯南奇怪的孩子	ke nan qi guai de hai zi	74
可遇见的码头惨剧	ke yu jian de ma tou can ju	110
恐怖的登山杀人事件	kong bu de deng shan sha ren shi jian	271
堀田三兄弟杀人事件	ku tian san xiong di sha ren shi jian	310
来自小丑的图片邮件	lai zi xiao chou de tu pian you jian	79
来自芝加哥的男子	lai zi zhi jia ge de nan zi	167
栏杆损坏的了望台	lan gan sun huai de le wang tai	139
蓝色古堡搜索事件	lan se gu bao sou suo shi jian	242
浪花剑士与太阁之城	lang hua jian shi yu tai ge zhi cheng	164
浪花连续杀人事件	lang hua lian xu sha ren shi jian	254
离别美酒杀人事件	li bie mei jiu sha ren shi jian	267
恋人是春天的幻觉	lian ren shi chun tian de huan jue	114
列车手法杀人事件	lie che shou fa sha ren shi jian	300
临终的啊啊	lin zhong de a a	67
流过流水亭的杀机	liu guo liu shui ting de sha ji	227
流浪画家杀人事件	liu lang hua jia sha ren shi jian	280
六月新娘杀人事件	liu yue xin niang sha ren shi jian	332
龙神山坠落事件	long shen shan zhui luo shi jian	195
律师妃英理的证言	lv shi fei ying li de zheng yan	13
旅行戏团杀人事件	lv xing xi tuan sha ren shi jian	248
买卖繁盛的秘密	mai mai fan sheng de mi mi	187
满月之夜的二元神秘事件	man yue zhi ye de er yuan shen mi shi jian	121
毛利小五郎的冒充者	mao li xiao wu lang de mao chong zhe	176
美术馆杀人事件	mei shu guan sha ren shi jian	342
每月一份礼物威胁事件	mei yue yi fen li wu wei xie shi jian	343
蜜蜂鸡尾酒杀人事件	mi feng ji wei jiu sha ren shi jian	252
迷宫的阴暗	mi gong de yin an	155
米花町阁楼之家	mi hua ding ge lou zhi jia	83
米花之狼杀人事件	mi hua zhi lang sha ren shi jian	288
迷惘森林中的光彦	mi wang sen lin zhong de guang yan	150
谜样的身长相差二十厘米	mi yang de shen chang xiang cha er shi li mi	98
谜样的讯息狙击事件	mi yang de xun xi ju ji shi jian	336
名犬的功劳	ming quan de gong lao	73
名陶艺家杀人事件	ming tao yi jia sha ren shi jian	266
名侦探的会集	ming zhen tan de hui ji	190
明治维新神秘之旅	ming zhi wei xin shen mi zhi lv	4
魔女栖息的糖果之家	mo nv qi xi de tang guo zhi jia	109
魔术爱好者杀人事件	mo shu ai hao zhe sha ren shi jian	244
目标毛利小五郎	mu biao mao li xiao wu lang	100
牧场的悲剧	mu chang de bei ju	171
目黑的秋刀鱼事件	mu hei de qiu dao yu shi jian	62
目暮尘封的秘密	mu mu chen feng de mi mi	191
南纪白滨的神秘之旅	nan ji bai bin de shen mi zhi lv	180
能回来的受害者	neng hui lai de shou hai zhe	144
鸟取县蜘蛛公馆的怪事	niao qu xian zhi zhu gong guan de guai shi	223
偶像们的秘密	ou xiang men de mi mi	172
偶像密室杀人事件	ou xiang mi shi sha ren shi jian	347
螃蟹和鲸鱼绑架事件	pang xie he jing yu bang jia shi jian	292
烹饪教室杀人事件	peng ren jiao shi sha ren shi jian	259
破碎的十二星座图	po sui de shi er xing zuo tu	9
汽车爆炸事件的真相	qi che bao zha shi jian de zhen xiang	233
奇怪的寻人事件	qi guai de xun ren shi jian	337
奇妙一家的委托	qi miao yi jia de wei tuo	94
企业家千金杀人事件	qi ye jia qian jin sha ren shi jian	314
潜藏杀机的陶艺教室	qian cang sha ji de tao yi jiao shi	185
强盗犯人住院事件	qiang dao fan ren zhu yuan shi jian	272
窃盗集团别墅事件	qie dao ji tuan bie shu shi jian	263
寝室的酒窖	qin shi de jiu jiao	181
清洁车杀人事件	qing jie che sha ren shi jian	299
情人节的真实	qing ren jie de zhen shi	162
情人节杀人事件	qing ren jie sha ren shi jian	344
人鱼又再度哭泣	ren yu you zai du ku qi	188
三胞胎别墅杀人事件	san bao tai bie shu sha ren shi jian	287
丧失记忆的美少女事件	sang shi ji yi de mei shao nv shi jian	327
杀人犯工藤新一	sha ren fan gong teng xin yi	2
山庄绷带怪人杀人事件	shan zhuang beng dai guai ren sha ren shi jian	318
上户彩和新一	shang hu cai he xin yi	71
上野出发的北斗星	shang ye chu fa de bei dou xing	237
少年侦探队消失事件	shao nian zhen tan dui xiao shi shi jian	224
少年侦探团遇难事件	shao nian zhen tan tuan yu nan shi jian	286
神秘的狙击者杀人事件	shen mi de ju ji zhe sha ren shi jian	249
神秘老人失踪事件	shen mi lao ren shi zong shi jian	232
神秘凶器杀人事件	shen mi xiong qi sha ren shi jian	302
神社鸟居之惊悚暗号	shen she niao ju zhi jing song an hao	87
圣佛尼号连续杀人事件	sheng fo ni hao lian xu sha ren shi jian	219
生日葡萄酒之谜	sheng ri pu tao jiu zhi mi	131
谁的推理秀	shui de tui li xiu	101
谁都不在了	shui dou bu zai le	69
水流石庭的玄机	shui liu shi ting de xuan ji	153
水中的钥匙密室事件	shui zhong de yao shi mi shi shi jian	230
四处辗转的游戏软件	si chu zhan zhuan de you xi ruan jian	107
似乎是绑架的事件	si hu shi bang jia de shi jian	97
四辆保时捷	si liang bao shi jie	125
死神阵内杀人事件	si shen zhen nei sha ren shi jian	285
斯特拉迪瓦里小提琴的不和谐音	si te la di wa li xiao ti qin de bu he xie yin	28
松江玉造连句十四回合定胜负	song jiang yu zao lian ju shi si hui he ding sheng fu	169
松茸和熊与侦探队	song rong he xiong yu zhen tan dui	193
叹气赶海	tan qi gan hai	65
桃太郎解密之旅	tao tai lang jie mi zhi lv	102
提问婆婆失踪事件	ti wen po po shi zong shi jian	159
天气预报小姐诱拐事件	tian qi yu bao xiao jie you guai shi jian	250
天下第一夜祭杀人事件	tian xia di yi ye ji sha ren shi jian	341
同时进行的舞台和绑架	tong shi jin xing de wu tai he bang jia	88
图书馆杀人事件	tu shu guan sha ren shi jian	305
推理对决	tui li dui jue	10
推理小说家失踪事件	tui li xiao shuo jia shi zong shi jian	255
外交官杀人事件	wai jiao guan sha ren shi jian	306
完美的名推理	wan mei de ming tui li	197
完全一半犯罪之谜	wan quan yi ban fan zui zhi mi	86
维纳斯之吻	wei na si zhi wen	222
危险的处方笺	wei xian de chu fang jian	213
我喜爱的神秘旅行	wo xi ai de shen mi lv xing	56
五彩传说的水底龙宫	wu cai chuan shuo de shui di long gong	194
无法归来的二人	wu fa gui lai de er ren	75
无法消灭的证据	wu fa xiao mie de zheng ju	182
无声的证据	wu sheng de zheng ju	141
舞台女演员杀人事件	wu tai nv yan yuan sha ren shi jian	290
雾天狗传说杀人事件	wu tian gou chuan shuo sha ren shi jian	303
屋形船震惊的钓鱼	wu xing chuan zhen jing de diao yu	147
夕阳染红的女儿节人偶	xi yang ran hong de nv er jie ren ou	140
仙人掌花杀人事件	xian ren zhang hua sha ren shi jian	316
限时十五时	xian shi shi wu shi	103
嫌疑犯毛利小五郎	xian yi fan mao li xiao wu lang	200
像公主的人	xiang gong zhu de ren	128
向日葵馆的枪声	xiang ri kui guan de qiang sheng	175
消失的绑架逃逸车	xiao shi de bang jia tao yi che	134
消失的尸体杀人事件	xiao shi de shi ti sha ren shi jian	335
消失的凶器搜索事件	xiao shi de xiong qi sou suo shi jian	243
消失的巡警	xiao shi de xun jing	35
消失的一页	xiao shi de yi ye	52
小五郎同学会杀人事件	xiao wu lang tong xue hui sha ren shi jian	324
小五郎约会杀人事件	xiao wu lang yue hui sha ren shi jian	269
小小的目击者	xiao xiao de mu ji zhe	154
小小的委托者	xiao xiao de wei tuo zhe	116
新干线大爆炸事件	xin gan xian da bao zha shi jian	345
新干线护送事件	xin gan xian hu song shi jian	178
辛辣苦口却又甘甜的汤	xin la ku kou que you gan tian de tang	95
新闻照片杀人事件	xin wen zhao pian sha ren shi jian	262
新一的真实身份和小兰的眼泪	xin yi de zhen shi shen fen he xiao lan de yan lei	1
新一回来了	xin yi hui lai le	205
新一少年时的冒险	xin yi shao nian shi de mao xian	43
星期一晚上七时三十分杀人事件	xing qi yi wan shang qi shi san shi fen sha ren shi jian	317
星星和香烟的暗号	xing xing he xiang yan de an hao	104
幸运的雪茄盒	xing yun de xue jia he	136
雪女传说杀人事件	xue nv chuan shuo sha ren shi jian	270
雪山山庄杀人事件	xue shan shan zhuang sha ren shi jian	308
寻找屁股上的印记	xun zhao pi gu shang de yin ji	120
演讲厅神秘事件	yan jiang ting shen mi shi jian	192
鷃鼠星人之谜事件	yan shu xing ren zhi mi shi jian	261
阳光普照的地方	yang guang pu zhao de di fang	138
摇动的餐馆	yao dong de can guan	166
夜路杀人事件	ye lu sha ren shi jian	291
疑惑的咖喱饭	yi huo de ga li fan	129
疑惑的天体观测	yi huo de tian ti guan ce	238
伊卡尔斯的黑色之翼	yi ka er si de hei se zhi yi	198
一直说谎的委托人	yi zhi shuo huang de wei tuo ren	189
银行抢匪杀人事件	yin hang qiang fei sha ren shi jian	281
银杏色的初恋	yin xing se de chu lian	81
因缘和友情的试映会	yin yuan he you qing de shi ying hui	58
英语教师和西部名侦探	ying yu jiao shi he xi bu ming zhen tan	156
诱拐现场特定事件	you guai xian chang te ding shi jian	276
游乐园高空弹跳事件	you le yuan gao kong tan tiao shi jian	234
幽灵船杀人事件	you ling chuan sha ren shi jian	295
幽灵屋的真相	you ling wu de zhen xiang	158
友情与杀意的关门海峡	you qing yu sha yi de guan men hai xia	146
优胜锦旗被割事件	you sheng jin qi bei ge shi jian	313
有氧潜水杀人事件	you yang qian shui sha ren shi jian	256
与黑暗组织的再会	yu hei an zu zhi de zai hui	217
浴室密室事件	yu shi mi shi shi jian	251
鱼邮件的追踪	yu you jian de zhui zong	70
元太的必杀曲线球	yuan tai de bi sha qu xian qiu	40
元太少年的灾难	yuan tai shao nian de zai nan	177
园子的红手帕	yuan zi de hong shou pa	55
园子的夏日海滩冒险物语	yuan zi de xia ri hai tan mao xian wu yu	231
约定的场所	yue ding de chang suo	204
月亮和星星与太阳的秘密	yue liang he xing xing yu tai yang de mi mi	225
云霄飞车杀人事件	yun xiao fei che sha ren shi jian	349
在黑暗中传出的神秘枪声	zai hei an zhong chuan chu de shen mi qiang sheng	210
在图画里面的绑架犯	zai tu hua li mian de bang jia fan	170
震动的警视厅	zhen dong de jing shi ting	143
真假人质绑票事件	zhen jia ren zhi bang piao shi jian	326
侦探团大追击事件	zhen tan tuan da zhui ji shi jian	260
侦探团和青虫四兄弟	zhen tan tuan he qing chong si xiong di	80
侦探团生还事件	zhen tan tuan sheng huan shi jian	319
治愈之森的不在场称证明	zhi yu zhi sen de bu zai chang cheng zheng ming	173
中华街雨中的似曾相识	zhong hua jie yu zhong de si ceng xiang shi	152
坠落事件的隐情	zhui luo shi jian de yin qing	126
追逐兰色小鸟的少年侦探团	zhui zhu lan se xiao niao de shao nian zhen tan tuan	85
综合病院杀人事件	zong he bing yuan sha ren shi jian	278
走头无路的名侦探	zou tou wu lu de ming zhen tan	268
足球选手恐吓事件	zu qiu xuan shou kong he shi jian	340
诅咒面具的冷笑	zu zhou mian ju de leng xiao	212
醉在萨摩的小五郎	zui zai sa mo de xiao wu lang	99
最终播映杀人事件	zui zhong bo ying sha ren shi jian	241
