# 文件名：周华健歌曲歌词.scel
# 词库名：周华健歌曲歌词
# 词库分类：音乐
# 词库描述：
# 词条样例：最后圆舞曲 直到有一天远方的号角声响 就站在门内默默地垂泪 仿佛是想要留住他将远行的歌声 他转回身到爱人的身边
# 词条数量：303

爱你够不够多	ai ni gou bu gou duo	245
爱是漫长的旅途	ai shi man chang de lv tu	251
爱也匆匆恨也匆匆	ai ye cong cong hen ye cong cong	144
爱与恨情难独钟	ai yu hen qing nan du zhong	153
把那无知的疯狂当做偶像崇拜	ba na wu zhi de feng kuang dang zuo ou xiang chong bai	67
悲哀中少女的歌	bei ai zhong shao nv de ge	285
悲欢离合人间路	bei huan li he ren jian lu	249
悲与欢苍天捉弄	bei yu huan cang tian zhuo nong	138
编织你我重逢相遇时无言的声韵	bian zhi ni wo chong feng xiang yu shi wu yan de sheng yun	46
不会将爱恨合分视若等闲	bu hui jiang ai hen he fen shi ruo deng xian	200
不认输	bu ren shu	237
不要悲伤亲爱的姑娘	bu yao bei shang qin ai de gu niang	132
不愿让你看见我的伤处	bu yuan rang ni kan jian wo de shang chu	242
唱这首短歌表达我的深爱	chang zhe shou duan ge biao da wo de shen ai	70
唱着永不分离来	chang zhe yong bu fen li lai	134
唱着永恒的恋曲	chang zhe yong heng de lian qu	135
潮起又潮落	chao qi you chao luo	218
晨光与那万物在微笑	chen guang yu na wan wu zai wei xiao	103
春去春会来	chun qu chun hui lai	227
从不轻易让人懂	cong bu qing yi rang ren dong	232
带着他忧伤的情感与歌声	dai zhe ta you shang de qing gan yu ge sheng	279
但事到如今那些偶像都已破灭	dan shi dao ru jin na xie ou xiang dou yi po mie	66
当繁华游戏终于落幕	dang fan hua you xi zhong yu luo mu	108
当我闭上双眼仿佛看见你在眼前	dang wo bi shang shuang yan fang fu kan jian ni zai yan qian	64
当我闭上双眼仿佛听见你对我耳语	dang wo bi shang shuang yan fang fu ting jian ni dui wo er yu	62
点燃起一支蜡烛	dian ran qi yi zhi la zhu	73
点缀着无数尘世烦恼	dian zhui zhe wu shu chen shi fan nao	109
对你够不够好	dui ni gou bu gou hao	244
多亏有你处处留了颜面	duo kui you ni chu chu liu le yan mian	207
多少爱多少恋多少思多少盼只留下惆怅一片	duo shao ai duo shao lian duo shao si duo shao pan zhi liu xia chou chang yi pian	19
多少往事多少烟尘总使我泪湿衣襟	duo shao wang shi duo shao yan chen zong shi wo lei shi yi jin	22
恩和怨是幻是空	en he yuan shi huan shi kong	149
而我知道那不是梦幻	er wo zhi dao na bu shi meng huan	43
而我知道那只是梦幻数年的思念累积成双鬓的白发	er wo zhi dao na zhi shi meng huan shu nian de si nian lei ji cheng shuang bin de bai fa	50
仿佛是想要唤回他快唱完的歌声	fang fu shi xiang yao huan hui ta kuai chang wan de ge sheng	269
仿佛是想要留住他将远行的歌声	fang fu shi xiang yao liu zhu ta jiang yuan xing de ge sheng	290
放心的追逐	fang xin de zhui zhu	252
风也过雨也走	feng ye guo yu ye zou	192
风雨无阻	feng yu wu zu	266
浮现脑海你一身纯白	fu xian nao hai ni yi shen chun bai	123
感情事怎会随便	gan qing shi zen hui sui bian	201
歌声带着爱怜	ge sheng dai zhe ai lian	267
给你我的全部	gei ni wo de quan bu	265
给你一条我的路	gei ni yi tiao wo de lu	256
共尝那苹果派	gong chang na ping guo pai	115
共听日月唱首歌	gong ting ri yue chang shou ge	230
孤独中带着少许悲哀	gu du zhong dai zhe shao xu bei ai	131
鼓足了勇气把口儿开	gu zu le yong qi ba kou er kai	119
还记得坚持甚麽	hai ji de jian chi shen mo	190
海上孤帆在窗外飘流人去楼空只留下一个结	hai shang gu fan zai chuang wai piao liu ren qu lou kong zhi liu xia yi ge jie	6
还要走还有我	hai yao zou hai you wo	179
还有伤还有痛	hai you shang hai you tong	180
孩子的双手	hai zi de shuang shou	86
和蔼的云是父亲的笑容	he ai de yun shi fu qin de xiao rong	88
何时才能才能看见幸福和平与温暖的明天	he shi cai neng cai neng kan jian xing fu he ping yu wen nuan de ming tian	59
何时才能走到幸福和平与温暖的终点	he shi cai neng zou dao xing fu he ping yu wen nuan de zhong dian	52
黑夜又白昼	hei ye you bai zhou	229
恨不能相逢	hen bu neng xiang feng	145
狠狠面对人生每次寒冷	hen hen mian dui ren sheng mei ci han leng	177
红尘千山万里路	hong chen qian shan wan li lu	258
呼唤人们走向战场保卫家乡	hu huan ren men zou xiang zhan chang bao wei jia xiang	296
呼唤她走向爱人所在的地方	hu huan ta zou xiang ai ren suo zai de di fang	275
花瓣泪飘落风中	hua ban lei piao luo feng zhong	223
花的心藏在蕊中	hua de xin cang zai rui zhong	235
花谢花会再开	hua xie hua hui zai kai	226
花心	hua xin	236
黄色的阳伞下	huang se de yang san xia	121
会寂寞会回首	hui ji mo hui hui shou	188
几番欺几番怨几番诉几番恋只落得寂寞一片	ji fan qi ji fan yuan ji fan su ji fan lian zhi luo de ji mo yi pian	20
即将由远而近传入我心里像那从天上落下来的雨投向大地怀中	ji jiang you yuan er jin chuan ru wo xin li xiang na cong tian shang la xia lai de yu tou xiang da di huai zhong	17
继续踩着你的足印	ji xu cai zhe ni de zu yin	55
将真话说得肤浅	jiang zhen hua shuo de fu qian	205
交叠织成一副是你的回忆但如今伴我只是一个结	jiao die zhi cheng yi fu shi ni de hui yi dan ru jin ban wo zhi shi yi ge jie	3
交织的岁月里如斜风如细雨徘徊着无限凄迷	jiao zhi de sui yue li ru xie feng ru xi yu pai huai zhe wu xian qi mi	23
今夜你我相对如昔为什么不再美不再甜蜜	jin ye ni wo xiang dui ru xi wei shen me bu zai mei bu zai tian mi	29
今夜微风带来雨滴为什么沾湿了我的眼睛	jin ye wei feng dai lai yu di wei shen me zhan shi le wo de yan jing	25
今夜星光依然如息为什么不再撩动我的心	jin ye xing guang yi ran ru xi wei shen me bu zai liao dong wo de xin	31
静静等天荒地老	jing jing deng tian huang di lao	158
就站在门内默默地垂泪	jiu zhan zai men nei mo mo de chui lei	291
就站在身边	jiu zhan zai shen bian	270
看见他生生世世最牵挂的爱人	kan jian ta sheng sheng shi shi zui qian gua de ai ren	292
看见他朝朝暮暮最思念的爱人	kan jian ta zhao zhao mu mu zui si nian de ai ren	271
看着那水中虚幻的我	kan zhe na shui zhong xu huan de wo	110
可以要求不要不在乎	ke yi yao qiu bu yao bu zai hu	243
可以追求	ke yi zhui qiu	238
空把花期都错过	kong ba hua qi dou cuo guo	234
苦苦等待你的到来	ku ku deng dai ni de dao lai	127
快活一生悲哀一生	kuai huo yi sheng bei ai yi sheng	141
狂笑一声长叹一声	kuang xiao yi sheng chang tan yi sheng	142
来来往往的你我与他	lai lai wang wang de ni wo yu ta	166
来也匆匆去也匆匆	lai ye cong cong qu ye cong cong	146
了解你难如登天	liao jie ni nan ru deng tian	217
临去的时候他猛然回首	lin qu de shi hou ta meng ran hui shou	293
留在身边讨厌没有又挂念	liu zai shen bian tao yan mei you you gua nian	202
美丽的人生	mei li de ren sheng	169
门内却是一个更温暖的世界	men nei que shi yi ge geng wen nuan de shi jie	13
梦得够不够好	meng de gou bu gou hao	155
梦的够不够好	meng de gou bu gou hao	239
梦里知多少	meng li zhi duo shao	163
梦有快乐梦有痛苦	meng you kuai le meng you tong ku	250
蓦然回头来你已不在	mo ran hui tou lai ni yi bu zai	113
某个小岛	mou ge xiao dao	161
某年某月某日某一次拥抱	mou nian mou yue mou ri mou yi ci yong bao	160
某天涯海角	mou tian ya hai jiao	162
暮色晨光惊醒不了我对你的真情	mu se chen guang jing xing bu liao wo dui ni de zhen qing	36
那不曾抱怨伴我度过一生	na bu ceng bao yuan ban wo du guo yi sheng	91
那段永恒的誓言那段永恒的歌	na duan yong heng de shi yan na duan yong heng de ge	130
那令我站起身来面对一切	na ling wo zhan qi shen lai mian dui yi qie	93
那些日子不再有	na xie ri zi bu zai you	185
那依旧彷徨依旧不公平的世界	na yi jiu pang huang yi jiu bu gong ping de shi jie	60
哪一年哪一天才能够诉说尽才能够不再寻觅	na yi nian na yi tian cai neng gou su shuo jin cai neng gou bu zai xun mi	21
那一年上上的签	na yi nian shang shang de qian	197
拿着苹果派	na zhe ping guo pai	122
男人婆只是表面	nan ren po zhi shi biao mian	213
男人有时蠢话连篇	nan ren you shi chun hua lian pian	208
男人总是蠢话连篇	nan ren zong shi chun hua lian pian	203
你曾经唱过的漫长而逶迤的路	ni ceng jing chang guo de man chang er wei yi de lu	53
你的泪晶莹剔透	ni de lei jing ying ti tou	221
你的心忘了季节	ni de xin wang le ji jie	233
你可否明白	ni ke fou ming bai	126
你那不恐惧黑暗屈服的容颜	ni na bu kong ju hei an qu fu de rong yan	63
你什么都别说	ni shen me dou bie shuo	9
你是我今生唯一的赌注	ni shi wo jin sheng wei yi de du zhu	264
你是我一生不停的脚步	ni shi wo yi sheng bu ting de jiao bu	255
你说你是多么眷恋你曾深爱的世界	ni shuo ni shi duo me juan lian ni ceng shen ai de shi jie	61
你微笑的容颜一阵阵映在我心里	ni wei xiao de rong yan yi zhen zhen ying zai wo xin li	15
你终于翩翩而来	ni zhong yu pian pian er lai	120
年轻的歌手扛起了行囊	nian qing de ge shou kang qi le xing nang	295
宁静的心灵是我的向往	ning jing de xin ling shi wo de xiang wang	99
怕你孤单怕你孤独	pa ni gu dan pa ni gu du	259
怕你孤单怕你糊涂	pa ni gu dan pa ni hu tu	157
怕你忧伤怕你哭	pa ni you shang pa ni ku	260
陪伴在你身旁	pei ban zai ni shen pang	286
澎湃有如巨浪	peng pai you ru ju lang	82
朋友不曾孤单过	peng you bu ceng gu dan guo	182
朋友一生一起走	peng you yi sheng yi qi zou	186
苹果派你独爱苹果派	ping guo pai ni du ai ping guo pai	117
其实你心思细过锦缎缠绵	qi shi ni xin si xi guo jin duan chan mian	212
虔诚的心不会改变	qian cheng de xin bu hui gai bian	195
牵着我带着我走向永恒	qian zhe wo dai zhe wo zou xiang yong heng	95
憔悴的心灵不愿再回首	qiao cui de xin ling bu yuan zai hui shou	106
请别辜负我的期待	qing bie gu fu wo de qi dai	118
轻轻河畔草	qing qing he pan cao	159
全心的付出	quan xin de fu chu	261
让梦划向你心海	rang meng hua xiang ni xin hai	224
让你尽情飞舞	rang ni jin qing fei wu	253
让平凡的日子在温馨中度过	rang ping fan de ri zi zai wen xin zhong du guo	104
让软弱的我们懂得残忍	rang ruan ruo de wo men dong de can ren	178
让它过去让它永远的过去	rang ta guo qu rang ta yong yuan de guo qu	39
让我们握紧双手走在蒙蒙的雨中	rang wo men wo jin shuang shou zou zai meng meng de yu zhong	8
让我们心连着心走过未来的岁月	rang wo men xin lian zhe xin zou guo wei lai de sui yue	7
让我牵着你的手走向灿烂的天明	rang wo qian zhe ni de shou zou xiang can lan de tian ming	38
让我燃起火炬	rang wo ran qi huo ju	56
让我甜笑在大地摇篮中	rang wo tian xiao zai da di yao lan zhong	98
让我无怨无悔	rang wo wu yuan wu hui	262
让我再次回味你曾说过的那些话	rang wo zai ci hui wei ni ceng shuo guo de na xie hua	57
让我在你身边	rang wo zai ni shen bian	198
让我再一次倾听着你的歌声	rang wo zai yi ci qing ting zhe ni de ge sheng	58
让我走出一片天空	rang wo zou chu yi pian tian kong	254
人满是浮华心却荒芜	ren man shi fu hua xin que huang wu	107
人生为欢有几何	ren sheng wei huan you ji he	228
日子久了就明白	ri zi jiu le jiu ming bai	211
伞下的座椅依然空白	san xia de zuo yi yi ran kong bai	124
善良的人	shan liang de ren	168
伤痕累累的天真的灵魂	shang hen lei lei de tian zhen de ling hun	171
圣洁的心是爱人的眼眸	sheng jie de xin shi ai ren de yan mou	85
声声的敲打在我心上	sheng sheng de qiao da zai wo xin shang	83
生与死一切成空	sheng yu si yi qie cheng kong	147
是曾经无悔的风雨无阻	shi ceng jing wu hui de feng yu wu zu	241
是我爱人眼中射出的光芒	shi wo ai ren yan zhong she chu de guang mang	90
是我父亲宽厚温暖的手掌	shi wo fu qin kuan hou wen nuan de shou zhang	94
是我孩子脸上闪动的泪光	shi wo hai zi lian shang shan dong de lei guang	92
是我母亲乳白色的胸膛	shi wo mu qin ru bai se de xiong tang	96
是与非懂也不懂	shi yu fei dong ye bu dong	151
时针已走了几格	shi zhen yi zou le ji ge	125
受伤的歌手睁开临终的眼眸	shou shang de ge shou zheng kai lin zhong de yan mou	272
受伤的他在爱人的身边	shou shang de ta zai ai ren de shen bian	268
手中苹果派两个	shou zhong ping guo pai liang ge	114
数年的思恋消逝为慢慢的长夜	shu nian de si lian xiao shi wei man man de chang ye	42
熟悉的旋律指引她寻觅	shu xi de xuan lv zhi yin ta xun mi	274
谁把谁真的当真	shui ba shui zhen de dang zhen	174
谁是唯一谁的人	shui shi wei yi shui de ren	172
谁说此情不变谁说等待万年谁说天长地久	shui shuo ci qing bu bian shui shuo deng dai wan nian shui shuo tian chang di jiu	28
谁说直到永远看着你看着我谁说过	shui shuo zhi dao yong yuan kan zhe ni kan zhe wo shui shuo guo	27
谁为谁心疼	shui wei shui xin teng	173
谁与我生死与共	shui yu wo sheng si yu gong	140
思绪是纠缠的结系着你的一切	si xu shi jiu chan de jie xi zhe ni de yi qie	4
诉说我的情怀	su shuo wo de qing huai	72
虽有悲意也从容	sui you bei yi ye cong rong	222
他们的生活里忘却了忧愁	ta men de sheng huo li wang que le you chou	299
他转回身到爱人的身边	ta zhuan hui shen dao ai ren de shen bian	289
躺在大地上不再迷惘	tang zai da di shang bu zai mi wang	100
提着昨日种种千辛万苦	ti zhe zuo ri zhong zhong qian xin wan ku	156
提着昨日总总千辛万苦	ti zhe zuo ri zong zong qian xin wan ku	247
甜酸的派滋味千百	tian suan de pai zi wei qian bai	112
天与地风起云涌	tian yu di feng qi yun yong	136
听见我在这里轻轻呼唤你的名字请问你是否常在夜半无人的时候	ting jian wo zai zhe li qing qing hu huan ni de ming zi qing wen ni shi fou chang zai ye ban wu ren de shi hou	47
同看海天成一色	tong kan hai tian cheng yi se	219
晚霞凄艳更添我心孤寂红结朱影烙我心扉	wan xia qi yan geng tian wo xin gu ji hong jie zhu ying lao wo xin fei	1
往往有缘没有份	wang wang you yuan mei you fen	175
忘忧草忘了就好	wang you cao wang le jiu hao	164
微风轻吻着我的脸庞	wei feng qing wen zhe wo de lian pang	101
为何不牵我的手	wei he bu qian wo de shou	231
为何你我也要相隔那么远请问你是否常在夜深人静的时候	wei he ni wo ye yao xiang ge na me yuan qing wen ni shi fou chang zai ye shen ren jing de shi hou	48
为何世间要分天涯与海际为何人们要有相聚与相离	wei he shi jian yao fen tian ya yu hai ji wei he ren men yao you xiang ju yu xiang li	49
微微的风母亲的温柔	wei wei de feng mu qin de wen rou	89
我不曾给你荣华的一切	wo bu ceng gei ni rong hua de yi qie	12
我曾经年少	wo ceng jing nian shao	69
我撑着伞在雨中等待等待着你熟悉的脚步声	wo cheng zhe san zai yu zhong deng dai deng dai zhe ni shu xi de jiao bu sheng	18
我刀割破长空	wo dao ge po chang kong	152
我得承认	wo de cheng ren	209
我等着看它是否真的灵验	wo deng zhe kan ta shi fou zhen de ling yan	196
我分不出来	wo fen bu chu lai	111
我和你如此相近想不到不再痴迷	wo he ni ru ci xiang jin xiang bu dao bu zai chi mi	26
我剑何去何从	wo jian he qu he cong	154
我看到星光迷离也看到月色凄清	wo kan dao xing guang mi li ye kan dao yue se qi qing	32
我看着窗外飞扬的尘埃	wo kan zhe chuang wai fei yang de chen ai	74
我可以缝缝补补	wo ke yi feng feng bu bu	248
我可以朝朝暮暮	wo ke yi zhao zhao mu mu	257
我哭泪洒心中	wo ku lei sa xin zhong	139
我俩相对无语一夜到天明	wo lia xiang dui wu yu yi ye dao tian ming	41
我俩携手并肩漫步在海滨	wo lia xie shou bing jian man bu zai hai bin	40
我听到风的呼吸也听到你的低息	wo ting dao feng de hu xi ye ting dao ni de di xi	30
我想告诉你	wo xiang gao su ni	10
我笑我狂我疯	wo xiao wo kuang wo feng	137
我醒一场春梦	wo xing yi chang chun meng	148
我要向一位曾经存在过的英雄	wo yao xiang yi wei ceng jing cun zai guo de ying xiong	71
我有几次心不在焉	wo you ji ci xin bu zai yan	206
我真不在乎再要多少时间	wo zhen bu zai hu zai yao duo shao shi jian	216
我只要你永远留在我的身边	wo zhi yao ni yong yuan liu zai wo de shen bian	11
我最美的发现	wo zui mei di fa xian	214
我醉一片朦胧	wo zui yi pian meng long	150
无端的思绪在梦里在泪里在雨中彷徨迟疑	wu duan de si xu zai meng li zai lei li zai yu zhong pang huang chi yi	24
夕阳残照红了我的剪影青山依旧你在何方	xi yang can zhao hong le wo de jian ying qing shan yi jiu ni zai he fang	5
向明天换一些美满和幸福	xiang ming tian huan yi xie mei man he xing fu	246
想起了他的歌和他的爱人	xiang qi le ta de ge he ta de ai ren	294
相识不如相忘淡淡一笑	xiang shi bu ru xiang wang dan dan yi xiao	165
相信他们曾经唱过的誓言	xiang xin ta men ceng jing chang guo de shi yan	277
心若倒悬仍感谢天	xin ruo dao xuan reng gan xie tian	215
心痛心酸心事太微不足道	xin tong xin suan xin shi tai wei bu zu dao	167
心中一定还有梦	xin zhong yi ding hai you meng	220
寻到受伤的歌手啊她的爱人	xun dao shou shang de ge shou a ta de ai ren	273
眼中带着眷恋	yan zhong dai zhe juan lian	288
眼中带着眷恋歌声带着爱恋	yan zhong dai zhe juan lian ge sheng dai zhe ai lian	133
也曾经徘徊	ye ceng jing pai huai	68
夜深人静的时候在我的眼前出现你如梦的身影	ye shen ren jing de shi hou zai wo de yan qian chu xian ni ru meng de shen ying	51
以后的相遇不再偶然	yi hou de xiang yu bu zai ou ran	128
一句话一辈子	yi ju hua yi bei zi	184
一切都隋风	yi qie dou sui feng	143
一声朋友你会懂	yi sheng peng you ni hui dong	181
一生情一杯酒	yi sheng qing yi bei jiu	183
依依不舍的爱过的人	yi yi bu she de ai guo de ren	176
因为我的歌声将永远陪伴在你的身旁	yin wei wo de ge sheng jiang yong yuan pei ban zai ni de shen pang	287
拥有够不够多	yong you gou bu gou duo	240
永远陪伴你	yong yuan pei ban ni	303
永远相偎相依	yong yuan xiang wei xiang yi	33
又到了夜深人静	you dao le ye shen ren jing	45
有过泪有过错	you guo lei you guo cuo	191
犹如宁静温暖的朝阳	you ru ning jing wen nuan de chao yang	76
有一位少女与一位歌手	you yi wei shao nv yu yi wei ge shou	300
雨为何下不停一丝丝沾湿了我的眼睛蓦然眼前出现	yu wei he xia bu ting yi si si zhan shi le wo de yan jing mo ran yan qian chu xian	16
远方归雁逐黄昏消逝冷清楼阁不复见你笑颜	yuan fang gui yan zhu huang hun xiao shi leng qing lou ge bu fu jian ni xiao yan	2
愿与你共过心	yuan yu ni gong guo xin	116
远远看见那简陋的家门	yuan yuan kan jian na jian lou de jia men	14
越是在意越是想不周延	yue shi zai yi yue shi xiang bu zhou yan	204
云雾湿透了我的外衣与你的长裙	yun wu shi tou le wo de wai yi yu ni de chang qun	37
在等待的日子里想	zai deng dai de ri zi li xiang	282
在漂泊的日子里她永远相信	zai piao bo de ri zi li ta yong yuan xiang xin	278
在我的眼前出现你如真的身影	zai wo de yan qian chu xian ni ru zhen de shen ying	44
在我心中照耀听那	zai wo xin zhong zhao yao ting na	75
在我胸中燃烧	zai wo xiong zhong ran shao	77
在相思的岁月里唱	zai xiang si de sui yue li chang	281
在一个动荡不安的年代	zai yi ge dong dang bu an de nian dai	301
早已不承认还有什么神	zao yi bu cheng ren hai you shen me shen	170
这些年一个人	zhe xie nian yi ge ren	193
真爱过才会懂	zhen ai guo cai hui dong	189
真善与美	zhen shan yu mei	87
直到有一天她听到熟悉的声响	zhi dao you yi tian ta ting dao shu xi de sheng xiang	276
直到有一天远方的号角声响	zhi dao you yi tian yuan fang de hao jiao sheng xiang	297
只留下一段岁月	zhi liu xia yi duan sui yue	263
只盼望今生今世永远	zhi pan wang jin sheng jin shi yong yuan	298
只想奔向那份安静	zhi xiang ben xiang na fen an jing	105
只要你不以为我癫	zhi yao ni bu yi wei wo dian	199
只要你的影与我的影相拥相偎依	zhi yao ni de ying yu wo de ying xiang yong xiang wei yi	34
只要你的影与我的影永远不分明	zhi yao ni de ying yu wo de ying yong yuan bu fen ming	35
只要你愿意	zhi yao ni yuan yi	225
只有你的名字依然在我心田	zhi you ni de ming zi yi ran zai wo xin tian	65
众人中我还是首选	zhong ren zhong wo hai shi shou xuan	210
众人中我会是首选	zhong ren zhong wo hui shi shou xuan	194
钟声呼唤如烈火	zhong sheng hu huan ru lie huo	78
钟声钪钪的响	zhong sheng kang kang de xiang	84
钟声隆隆的响	zhong sheng long long de xiang	80
终有梦终有你在心中	zhong you meng zhong you ni zai xin zhong	187
终于她走上了寻找的路	zhong yu ta zou shang le xun zhao de lu	280
撞击在岩石卷起千堆雪	zhuang ji zai yan shi juan qi qian dui xue	81
撞击在岩石开出千朵花	zhuang ji zai yan shi kai chu qian duo hua	79
自从第一次巧合	zi cong di yi ci qiao he	129
滋润我生命成长的源泉	zi run wo sheng ming cheng zhang de yuan quan	97
总是有不尽的爱	zong shi you bu jin de ai	284
总是有诉不完的情	zong shi you su bu wan de qing	283
走上那条永远永远也走不完的道路	zou shang na tiao yong yuan yong yuan ye zou bu wan de dao lu	54
走在那夜中不再忧伤	zou zai na ye zhong bu zai you shang	102
最后圆舞曲	zui hou yuan wu qu	302
