# 文件名：周杰伦的一些歌词.scel
# 词库名：周杰伦的一些歌词
# 词库分类：音乐
# 词库描述：
# 词条样例：娘子娘子却依旧每日折一枝杨柳 你在那里 在小村外的溪边 一壶好酒 再来一碗热粥 景色入秋漫天黄沙掠过
# 词条数量：113

把结局打开那薄如蝉翼的未来	ba jie ju da kai na bao ru chan yi de wei lai	74
被风吹乱	bei feng chui luan	42
北风乱夜未央	bei feng luan ye wei yang	35
闭上眼睛还能看见	bi shang yan jing hai neng kan jian	17
惨白的月弯弯勾住过往	can bai de yue wan wan gou zhu guo wang	49
潮起潮落	chao qi chao luo	97
沉默年代或许不该	chen mo nian dai huo xu bu gai	70
愁莫渡江	chou mo du jiang	29
凋谢的石道上命运不堪	diao xie de shi dao shang ming yun bu kan	30
风声不存在是我在感慨	feng sheng bu cun zai shi wo zai gan kai	76
芙蓉水面采船行影犹在	fu rong shui mian cai chuan xing ying you zai	55
故事在城外浓雾散不开	gu shi zai cheng wai nong wu san bu kai	78
还是让人难过心伤透	hai shi rang ren nan guo xin shang tou	94
花落人断肠我心事静静淌	hua luo ren duan chang wo xin shi jing jing tang	36
花已向晚	hua yi xiang wan	32
会不会有人可以明白	hui bu hui you ren ke yi ming bai	10
家乡的爹娘早已苍老了轮廓	jia xiang de die niang zao yi cang lao le lun kuo	90
接着紧紧闭上眼	jie zhe jin jin bi shang yan	8
经不起谁来拆	jing bu qi shui lai chai	73
景色入秋漫天黄沙凉过	jing se ru qiu man tian huang sha liang guo	88
景色入秋漫天黄沙掠过	jing se ru qiu man tian huang sha lue guo	102
菊花残满地伤	ju hua can man di shang	38
看不清对白你听不出来	kan bu qing dui bai ni ting bu chu lai	77
落寞近乡情怯的我	luo mo jin xiang qing qie de wo	85
马蹄声狂乱	ma ti sheng kuang luan	25
满脸风霜	man lian feng shuang	86
梦醒来是谁在窗台	meng xing lai shi shui zai chuang tai	75
梦在远方化成一缕香	meng zai yuan fang hua cheng yi lv xiang	41
默默的在等著我	mo mo de zai deng zhu wo	91
默默等待娘子	mo mo deng dai niang zi	107
默默等著我	mo mo deng zhu wo	110
牧草有没有	mu cao you mei you	100
那想念的身影	na xiang nian de shen ying	14
那在终点之前我愿意再爱一遍	na zai zhong dian zhi qian wo yuan yi zai ai yi bian	12
你的发香散得匆忙	ni de fa xiang san de cong mang	19
你的泪光	ni de lei guang	51
你的模样	ni de mu yang	39
你的笑容已泛黄	ni de xiao rong yi fan huang	37
你的影子剪不断	ni de ying zi jian bu duan	34
你会看不见	ni hui kan bu jian	1
你离去的痕迹	ni li qu de hen ji	16
你却不回来被岁月覆盖	ni que bu hui lai bei sui yue fu gai	54
你说的花开过去成空白	ni shuo de hua kai guo qu cheng kong bai	53
你无瑕的爱你从雨中来	ni wu xia de ai ni cong yu zhong lai	57
你在那里	ni zai na li	112
娘子娘子却依旧每日折一枝杨柳	niang zi niang zi que yi jiu mei ri zhe yi zhi yang liu	113
娘子却依旧每日折一枝杨柳	niang zi que yi jiu mei ri zhe yi zhi yang liu	92
娘子她人在江南等我泪不休语沉默	niang zi ta ren zai jiang nan deng wo lei bu xiu yu chen mo	93
娘子我欠你太多	niang zi wo qian ni tai duo	89
娘子依旧每日折一枝杨柳	niang zi yi jiu mei ri zhe yi zhi yang liu	109
凝结成了霜	ning jie cheng le shuang	47
怕你上不了岸一辈子摇晃	pa ni shang bu liao an yi bei zi yao huang	27
配上几斤的牛肉	pei shang ji jin de niu rou	104
飘落了灿烂	piao luo le can lan	31
千里之外你无声黑白	qian li zhi wai ni wu sheng hei bai	71
琴声何来生死难猜	qin sheng he lai sheng si nan cai	67
青苔天在山之外	qing tai tian zai shan zhi wai	60
秋心拆两半	qiu xin chai liang ban	28
让我不再想念你	rang wo bu zai xiang nian ni	6
柔弱中带伤	rou ruo zhong dai shang	50
如果说分手是苦痛的起点	ru guo shuo fen shou shi ku tong de qi dian	13
塞北的客栈人多	sai bei de ke zhan ren duo	101
什么恩怨过错	shen me en yuan guo cuo	96
诗化了悲哀我淋湿现在	shi hua le bei ai wo lin shi xian zai	56
失去你的地方	shi qu ni de di fang	20
世事看透江湖上	shi shi kan tou jiang hu shang	98
是谁在阁楼上冰冷的绝望	shi shui zai ge lou shang bing leng de jue wang	46
谁的江山	shui de jiang shan	26
随风飘散	sui feng piao san	40
太遥远的相爱	tai yao yuan de xiang ai	69
天微微亮你轻声地叹	tian wei wei liang ni qing sheng de tan	23
天涯尽头	tian ya jin tou	87
天涯之外你是否还在	tian ya zhi wai ni shi fou hai zai	68
天在山之外雨落花台	tian zai shan zhi wai yu luo hua tai	63
徒留我孤单在湖面成双	tu liu wo gu dan zai hu mian cheng shuang	33
闻泪声入林寻梨花白	wen lei sheng ru lin xun li hua bai	65
我等燕归来时间被安排	wo deng yan gui lai shi jian bei an pai	80
我会发着呆然后忘记你	wo hui fa zhe dai ran hou wang ji ni	9
我会发着呆然后微微笑	wo hui fa zhe dai ran hou wei wei xiao	5
我两鬓斑白闻泪声入林	wo liang bin ban bai wen lei sheng ru lin	62
我马儿有些瘦	wo ma er you xie shou	99
我说店玄三两银够不够	wo shuo dian xuan san liang yin gou bu gou	103
我送你离开	wo song ni li kai	72
我已经跟不上	wo yi jing gen bu shang	18
我一身的戎装呼啸沧桑	wo yi shen de rong zhuang hu xiao cang sang	24
我一生在纸上	wo yi sheng zai zhi shang	43
无能为力的	wu neng wei li de	83
屋檐如悬崖风铃如沧海	wu yan ru xuan ya feng ling ru cang hai	81
相思寄红豆	xiang si ji hong dou	84
想要对你说的不敢说的爱	xiang yao dui ni shuo de bu gan shuo de ai	11
想着那一天会有人代替	xiang zhe na yi tian hui you ren dai ti	7
心里的眼泪模糊了视线	xin li de yan lei mo hu le shi xian	2
寻梨花白只得一行	xun li hua bai zhi de yi xing	61
演一场意外你悄然走开	yan yi chang yi wai ni qiao ran zou kai	79
夜太漫长	ye tai man chang	48
一壶好酒	yi hu hao jiu	106
一身琉璃白透明着尘埃	yi shen liu li bai tou ming zhe chen ai	58
一夜惆怅如此委婉	yi ye chou chang ru ci wei wan	22
用一生	yong yi sheng	52
用一生去等待	yong yi sheng qu deng dai	66
又想那一年你温柔的脸	you xiang na yi nian ni wen rou de lian	4
雨落花台我等你来	yu luo hua tai wo deng ni lai	59
雨轻轻弹	yu qing qing tan	45
在多年以后	zai duo nian yi hou	95
再来一碗热粥	zai lai yi wan re zhou	105
在人海中漂泊心伤透	zai ren hai zhong piao bo xin shang tou	82
在我忘记之前	zai wo wang ji zhi qian	3
在小村外的溪边	zai xiao cun wai de xi bian	108
在小村外的溪边河口	zai xiao cun wai de xi bian he kou	111
在月光下一直找寻	zai yue guang xia yi zhi zhao xun	15
怎么隐藏我的悲伤	zen me yin cang wo de bei shang	21
只得一行青苔	zhi de yi xing qing tai	64
朱红色的窗	zhu hong se de chuang	44
