# 文件名：哆啦A梦电影大全.scel
# 词库名：哆啦A梦电影大全
# 词库分类：机器猫
# 词库描述：
# 词条样例：大雄的魔界大冒险 大雄和日本诞生 大雄与动物行星 大雄与梦幻三剑士 大雄的创世日记 大雄的发条都市冒险记
# 词条数量：32

大雄的创世日记	da xiong de chuang shi ri ji	17
大雄的发条都市冒险记	da xiong de fa tiao du shi mao xian ji	15
大雄的风之使者	da xiong de feng zhi shi zhe	9
大雄的恐龙	da xiong de kong long	7
大雄的猫狗时空传	da xiong de mao gou shi kong chuan	8
大雄的梦幻王国	da xiong de meng huan wang guo	20
大雄的魔界大冒险	da xiong de mo jie da mao xian	28
大雄的南海大冒险	da xiong de nan hai da mao xian	14
大雄的平行西游记	da xiong de ping xing xi you ji	24
大雄的奇迹之岛动物历险记	da xiong de qi ji zhi dao dong wu li xian ji	1
大雄的人鱼大海战	da xiong de ren yu da hai zhan	3
大雄的太阳王传说	da xiong de tai yang wang chuan shuo	12
大雄的小恐龙	da xiong de xiao kong long	32
大雄的新魔界大冒险	da xiong de xin mo jie da mao xian	6
大雄的新铁人兵团	da xiong de xin tie ren bing tuan	2
大雄的新宇宙开拓史	da xiong de xin yu zhou kai tuo shi	4
大雄的一千零一夜	da xiong de yi qian ling yi ye	21
大雄的宇宙开拓史	da xiong de yu zhou kai tuo shi	31
大雄的宇宙漂流记	da xiong de yu zhou piao liu ji	13
大雄的宇宙小战争	da xiong de yu zhou xiao zhan zheng	27
大雄和白金迷宫	da xiong he bai jin mi gong	19
大雄和海底鬼岩城	da xiong he hai di gui yan cheng	29
大雄和龙骑士	da xiong he long qi shi	25
大雄和日本诞生	da xiong he ri ben dan sheng	23
大雄和铁人兵团	da xiong he tie ren bing tuan	26
大雄和翼之勇者	da xiong he yi zhi yong zhe	11
大雄和银河超特急	da xiong he yin he chao te ji	16
大雄与动物行星	da xiong yu dong wu xing xing	22
大雄与绿巨人传	da xiong yu lv ju ren chuan	5
大雄与梦幻三剑士	da xiong yu meng huan san jian shi	18
大雄在大魔境	da xiong zai da mo jing	30
大雄在机器人王国	da xiong zai ji qi ren wang guo	10
