# 文件名：慢半拍——薛之谦.scel
# 词库名：慢半拍——薛之谦
# 词库分类：明星
# 词库描述：
# 词条样例：慢半拍 对过往的自己敬个礼 谁还敢逃避 我们模仿慢半拍的芭比 反正这世界早已那么差强人意 无视他们慢半拍的游戏
# 词条数量：44

别和这娱乐世界讲道理	bie he zhe yu le shi jie jiang dao li	18
从此再描写我也没关系	cong ci zai miao xie wo ye mei guan xi	24
从此再伤害我也没关系	cong ci zai shang hai wo ye mei guan xi	40
错过你美意	cuo guo ni mei yi	1
端庄的形体廉价的话题	duan zhuang de xing ti lian jia de hua ti	23
对过往的自己敬个礼	dui guo wang de zi ji jing ge li	41
对洁白的自己敬个礼	dui jie bai de zi ji jing ge li	25
反正那人心早已那么表里不一	fan zheng na ren xin zao yi na me biao li bu yi	14
反正这世界早已那么差强人意	fan zheng zhe shi jie zao yi na me cha qiang ren yi	30
感谢他们慢半拍的才艺	gan xie ta men man ban pai de cai yi	13
管他什么主题	guan ta shen me zhu ti	19
还好这世界早已那么褒贬不一	hai hao zhe shi jie zao yi na me bao bian bu yi	5
和人潮一起别标新立异	he ren chao yi qi bie biao xin li yi	20
和人潮一起偶尔还跃起	he ren chao yi qi ou er hai yue qi	35
互相赞美是我们心意	hu xiang zan mei shi wo men xin yi	21
接受过蚂蚁簇拥过华丽	jie shou guo ma yi cu yong guo hua li	39
精挑细选的心洗也洗不干净	jing tiao xi xuan de xin xi ye xi bu gan jing	6
慢半拍	man ban pai	44
漫天纸醉金迷这算不上滑稽	man tian zhi zui jin mi zhe suan bu shang hua ji	31
你还要我讲什么大道理	ni hai yao wo jiang shen me da dao li	11
浓妆艳抹是我的心意	nong zhuang yan mo shi wo de xin yi	37
谁还敢逃避	shui hai gan tao bi	38
谁靠近谁远离谁看惯谁看腻	shui kao jin shui yuan li shui kan guan shui kan ni	15
随便找个主题	sui bian zhao ge zhu ti	34
所以我们要原谅慢半拍的情敌	suo yi wo men yao yuan liang man ban pai de qing di	29
它让人歇斯底里慢半拍的自己	ta rang ren xie si di li man ban pai de zi ji	4
我没兴趣和你讲大道理	wo mei xing qu he ni jiang da dao li	26
我们放任慢半拍的身体	wo men fang ren man ban pai de shen ti	16
我们怀念	wo men huai nian	9
我们怀念慢半拍的爱情	wo men huai nian man ban pai de ai qing	8
我们模仿慢半拍的芭比	wo men mo fang man ban pai de ba bi	33
我们剩下慢半拍的自己	wo men sheng xia man ban pai de zi ji	3
我们失去慢半拍的勇气	wo men shi qu man ban pai de yong qi	7
我们要做慢半拍的芭比	wo men yao zuo man ban pai de ba bi	17
我们移动慢半拍的身体	wo men yi dong man ban pai de shen ti	32
无视他们慢半拍的游戏	wu shi ta men man ban pai de you xi	28
献给时代审美统一	xian gei shi dai shen mei tong yi	36
要乐此不疲	yao le ci bu pi	22
要什么大道理	yao shen me da dao li	10
在拥挤里耗尽我们都硬着心	zai yong ji li hao jin wo men dou ying zhe xin	2
这年头谁挑剔反正一片狼藉	zhe nian tou shui tiao ti fan zheng yi pian lang ji	27
这年头谁在意感情已像儿戏	zhe nian tou shui zai yi gan qing yi xiang er xi	12
作词薛之谦	zuo ci xue zhi qian	43
作曲许嵩	zuo qu xu song	42
