# 文件名：爱情公寓词库.scel
# 词库名：爱情公寓词库
# 词库分类：电影电视
# 词库描述：
# 词条样例：胡一菲 张伟 秦羽墨 胡小菲 贱人曾 好男人就是我我就是曾小贤
# 词条数量：26

曾小贤	ceng xiao xian	25
陈美嘉	chen mei jia	22
弹一闪弹二闪弹百闪	dan yi shan dan er shan dan bai shan	1
关谷	guan gu	13
关谷神奇	guan gu shen qi	23
好男人就是我我就是曾小贤	hao nan ren jiu shi wo wo jiu shi ceng xiao xian	10
胡小菲	hu xiao fei	16
胡一菲	hu yi fei	26
活到老学到老	huo dao lao xue dao lao	9
贱人曾	jian ren ceng	15
林宛瑜	lin wan yu	20
陆展博	lu zhan bo	19
吕小布	lv xiao bu	12
吕子乔	lv zi qiao	21
秦羽墨	qin yu mo	17
人家还没有想好要和谁在一起呢	ren jia hai mei you xiang hao yao he shui zai yi qi ne	4
他要挟我让我做牛做马	ta yao xie wo rang wo zuo niu zuo ma	5
他怎么会说我订婚了呢	ta zen me hui shuo wo ding hun le ne	7
唐小悠	tang xiao you	14
唐悠悠	tang you you	24
我分分钟切腹给你看	wo fen fen zhong qie fu gei ni kan	2
我要切腹自尽	wo yao qie fu zi jin	3
我已经找到打败你的方法了	wo yi jing zhao dao da bai ni de fang fa le	6
相信梦想相信奇迹	xiang xin meng xiang xiang xin qi ji	8
张伟	zhang wei	18
张益达	zhang yi da	11
