# 文件名：致我们单纯的小美好【官方推荐】.scel
# 词库名：致我们单纯的小美好【官方推荐】
# 词库分类：电影电视
# 词库描述：
# 词条样例：江辰 蠢萌逗比 沈月 王梓薇 高至霆 心外科医生
# 词条数量：102

八班	ba ban	79
变出你和我对话	bian chu ni he wo dui hua	70
别管它被怀疑被打压	bie guan ta bei huai yi bei da ya	67
辰希夫妇	chen xi fu fu	96
陈小希	chen xiao xi	100
充满我爱的事的家	chong man wo ai de shi de jia	60
初心染一路芳华	chu xin ran yi lu fang hua	48
蠢萌逗比	chun meng dou bi	98
蠢萌漫画家	chun meng man hua jia	86
大哥	da ge	4
大姐大	da jie da	3
多少日夜辗转放不下	duo shao ri ye zhan zhuan fang bu xia	50
翻页游戏我配合你导	fan ye you xi wo pei he ni dao	13
分心看我偷笑	fen xin kan wo tou xiao	14
腹黑傲娇	fu hei ao jiao	75
高冷学霸	gao leng xue ba	99
告诉我会实现吧	gao su wo hui shi xian ba	54
告诉我会实现吧会	gao su wo hui shi xian ba hui	47
告诉我这是梦吧	gao su wo zhe shi meng ba	63
高至霆	gao zhi ting	91
胡一天	hu yi tian	101
画家希	hua jia xi	6
假如我是宇宙混沌	jia ru wo shi yu zhou hun dun	74
江辰	jiang chen	102
静下来听心底的回答	jing xia lai ting xin di de hui da	66
来吧别害怕	lai ba bie hai pa	56
李束	li shu	83
李薇	li wei	88
林静晓	lin jing xiao	95
陆杨	lu yang	89
吕艳	lv yan	80
满腹辛辣满喉喑哑	man fu xin la man hou yin ya	49
每个瞬间都很闪耀	mei ge shun jian dou hen shan yao	18
每个音符都很美妙	mei ge yin fu dou hen mei miao	16
梦啊	meng a	51
梦里	meng li	45
梦里所有磨难开出了花	meng li suo you mo nan kai chu le hua	52
梦里所有挣扎破出了芽	meng li suo you zheng zha po chu le ya	59
描绘未来的那个	miao hui wei lai de na ge	61
哪里会让你牵挂	na li hui rang ni qian gua	2
哪里会让我停下	na li hui rang wo ting xia	68
难以放掉	nan yi fang diao	21
难以戒掉	nan yi jie diao	26
你的睫毛你的冷傲	ni de jie mao ni de leng ao	39
你的手套你的心跳	ni de shou tao ni de xin tiao	31
你的手指你的味道	ni de shou zhi ni de wei dao	33
你的嘴角你的微笑	ni de zui jiao ni de wei xiao	37
你会知道	ni hui zhi dao	41
你明白啊	ni ming bai a	64
你是甜的药	ni shi tian de yao	11
你在那里微笑看我	ni zai na li wei xiao kan wo	58
偶尔心情感冒发烧	ou er xin qing gan mao fa shao	12
乔露	qiao lu	73
全世界都知道嘲笑别恼	quan shi jie dou zhi dao chao xiao bie nao	36
沈月	shen yue	97
是梦吧	shi meng ba	93
是什么失去了心会痛	shi shen me shi qu le xin hui tong	65
是我的梦话	shi wo de meng hua	62
孙宁	sun ning	81
所有磨难开出了花	suo you mo nan kai chu le hua	44
天才医生	tian cai yi sheng	77
王梓薇	wang zi wei	94
温柔地说	wen rou de shuo	57
温柔地说来吧别害怕	wen rou de shuo lai ba bie hai pa	43
我多耐心请你等着瞧	wo duo nai xin qing ni deng zhe qiao	30
我多喜欢你	wo duo xi huan ni	42
我多喜欢你你会知道	wo duo xi huan ni ni hui zhi dao	20
我多喜欢你我不知道	wo duo xi huan ni wo bu zhi dao	25
我会继续请你准备好	wo hui ji xu qing ni zhun bei hao	35
我喜欢你打篮球	wo xi huan ni da lan qiu	19
我喜欢你的衬衫	wo xi huan ni de chen shan	34
我喜欢你的酒窝	wo xi huan ni de jiu wo	38
我喜欢你的眼睛	wo xi huan ni de yan jing	40
我喜欢你陪我看书	wo xi huan ni pei wo kan shu	15
我喜欢你弹钢琴	wo xi huan ni tan gang qin	17
我想做你的棉袄	wo xiang zuo ni de mian ao	32
我知道啊我知道啊	wo zhi dao a wo zhi dao a	55
吴柏松	wu bai song	92
无国界医生	wu guo jie yi sheng	84
喜欢你让数学题简单了	xi huan ni rang shu xue ti jian dan le	8
喜欢你让下雪天温暖了	xi huan ni rang xia xue tian wen nuan le	23
喜欢你让下雨天放晴了	xi huan ni rang xia yu tian fang qing le	24
喜欢你让英文书有趣了	xi huan ni rang ying wen shu you qu le	9
喜欢你已变成习惯	xi huan ni yi bian cheng xi guan	27
喜欢你已变成信仰	xi huan ni yi bian cheng xin yang	22
喜欢你在每一处每一角	xi huan ni zai mei yi chu mei yi jiao	28
喜欢你在每一刻每一秒	xi huan ni zai mei yi ke mei yi miao	29
小吧主	xiao ba zhu	90
小弟	xiao di	1
小希	xiao xi	5
心外科医生	xin wai ke yi sheng	87
也许是仙女施了个魔法	ye xu shi xian nv shi le ge mo fa	71
医生辰	yi sheng chen	7
有你烦恼全消	you ni fan nao quan xiao	10
元气少女	yuan qi shao nv	76
张何昊臻	zhang he hao zhen	82
张世亮	zhang shi liang	78
赵乾乾	zhao qian qian	85
赵越	zhao yue	72
这繁华世界让人应接不暇	zhe fan hua shi jie rang ren ying jie bu xia	69
住满我爱的人的家	zhu man wo ai de ren de jia	53
住满我爱的所有的家	zhu man wo ai de suo you de jia	46
