# 文件名：阮以伟.scel
# 词库名：阮以伟
# 词库分类：明星
# 词库描述：
# 词条样例：阮总 妈妈说的话 鸳鸯泪 折翼的翅膀 暖暖的阮以伟
# 词条数量：47

爱情不是拍戏	ai qing bu shi pai xi	32
奔跑吧青春阮以伟	ben pao ba qing chun ruan yi wei	25
回家	hui jia	37
家阮以伟	jia ruan yi wei	31
凌阮以伟	ling ruan yi wei	21
妈妈说的话	ma ma shuo de hua	39
魅力福州阮以伟	mei li fu zhou ruan yi wei	23
那年阮以伟	na nian ruan yi wei	12
你是唯一的郎	ni shi wei yi de lang	22
暖暖的阮以伟	nuan nuan de ruan yi wei	30
期待从来	qi dai cong lai	19
请你做我最爱的人	qing ni zuo wo zui ai de ren	26
娶媳妇不容易	qu xi fu bu rong yi	33
让恨像花儿一样	rang hen xiang hua er yi yang	13
阮家骄傲	ruan jia jiao ao	10
阮姓名人	ruan xing ming ren	11
阮以伟	ruan yi wei	47
阮以伟爱恋	ruan yi wei ai lian	8
阮以伟宝弟	ruan yi wei bao di	4
阮以伟歌曲	ruan yi wei ge qu	46
阮以伟回家	ruan yi wei hui jia	29
阮以伟简爱	ruan yi wei jian ai	44
阮以伟新单曲	ruan yi wei xin dan qu	5
阮以伟新歌	ruan yi wei xin ge	1
阮以伟新专辑	ruan yi wei xin zhuan ji	6
阮以伟音乐	ruan yi wei yin yue	45
阮以伟音乐节	ruan yi wei yin yue jie	2
阮以伟综艺节目	ruan yi wei zong yi jie mu	3
阮以伟最可爱	ruan yi wei zui ke ai	9
阮以伟最新歌曲	ruan yi wei zui xin ge qu	7
阮总	ruan zong	42
受伤的翅膀	shou shang de chi bang	40
谁是英雄阮以伟	shui shi ying xiong ruan yi wei	15
挽救阮以伟	wan jiu ruan yi wei	28
为你写首歌	wei ni xie shou ge	41
伪装阮以伟	wei zhuang ruan yi wei	24
我不会忘记	wo bu hui wang ji	35
我们今天结婚啦	wo men jin tian jie hun la	43
消失的画面	xiao shi de hua mian	14
需要你阮以伟	xu yao ni ruan yi wei	17
永远的沉默	yong yuan de chen mo	27
雨过彩虹阮以伟	yu guo cai hong ruan yi wei	16
鸳鸯泪	yuan yang lei	38
折翼的翅膀	zhe yi de chi bang	36
止步谎言	zhi bu huang yan	18
终点阮以伟	zhong dian ruan yi wei	20
醉心故事	zui xin gu shi	34
