# 文件名：黎锦涛.scel
# 词库名：黎锦涛
# 词库分类：其它
# 词库描述：
# 词条样例：提高网店销量 跟进客户订单 具体而言 必须具备较好的文字表达能力 热情耐心诚信 修改价格
# 词条数量：19

帮助买家选择合适的商品	bang zhu mai jia xuan ze he shi de shang pin	18
必须具备较好的文字表达能力	bi xu ju bei jiao hao de wen zi biao da neng li	13
促成交易	cu cheng jiao yi	17
打消顾虑	da xiao gu lv	19
打字速度快	da zi su du kuai	11
发货确认收货评价等操作	fa huo que ren shou huo ping jia deng cao zuo	1
跟进客户订单	gen jin ke hu ding dan	15
关闭订单	guan bi ding dan	3
具体而言	ju ti er yan	14
了解交易流程	liao jie jiao yi liu cheng	6
能与客户进行有效的交流	neng yu ke hu jin xing you xiao de jiao liu	7
能准确介绍商品描述和说明	neng zhun que jie shao shang pin miao shu he shuo ming	12
热情耐心诚信	re qing nai xin cheng xin	8
申请退款	shen qing tui kuan	2
熟悉商品付款	shu xi shang pin fu kuan	5
提高网店销量	ti gao wang dian xiao liang	16
信息回复及时	xin xi hui fu ji shi	9
修改价格	xiu gai jia ge	4
一般要求字分钟以上	yi ban yao qiu zi fen zhong yi shang	10
