# 文件名：山东外加剂厂家.scel
# 词库名：山东外加剂厂家
# 词库分类：化工
# 词库描述：
# 词条样例：山东滨州高效减水剂厂 济南力厚化工有限公司 聊城市靳氏外加剂厂 济南鑫利源化工有限公司联系人 济南多维桥化工有限责任公司
# 词条数量：110

爱敬化学青岛有限公司	ai jing hua xue qing dao you xian gong si	74
滨州市胜达化工有限公司	bin zhou shi sheng da hua gong you xian gong si	100
德州中科新型建材有限公司	de zhou zhong ke xin xing jian cai you xian gong si	77
东营区新科砼外加剂厂	dong ying qu xin ke tong wai jia ji chang	105
东营瑞源混凝土外加剂有限公司	dong ying rui yuan hun ning tu wai jia ji you xian gong si	106
东营市东宇混凝土外加剂厂	dong ying shi dong yu hun ning tu wai jia ji chang	104
东营市神龙新型建材有限公司	dong ying shi shen long xin xing jian cai you xian gong si	102
广饶振勇建筑外加剂	guang rao zhen yong jian zhu wai jia ji	103
菏泽创宏建材有限公司	he ze chuang hong jian cai you xian gong si	108
菏泽联强建筑材料有限公司	he ze lian qiang jian zhu cai liao you xian gong si	107
宏达建材	hong da jian cai	30
宏祥建筑外加剂厂	hong xiang jian zhu wai jia ji chang	27
华圣金凯建材有限公司	hua sheng jin kai jian cai you xian gong si	80
济南多维桥化工有限责任公司	ji nan duo wei qiao hua gong you xian ze ren gong si	98
济南国泰化工有限公司	ji nan guo tai hua gong you xian gong si	89
济南恒诚化工有限公司	ji nan heng cheng hua gong you xian gong si	91
济南恒达特种建材有限公司	ji nan heng da te zhong jian cai you xian gong si	90
济南华泰隆化工有限公司	ji nan hua tai long hua gong you xian gong si	85
济南惠泽新型建材有限公司	ji nan hui ze xin xing jian cai you xian gong si	96
济南凯骏化工供应减水剂	ji nan kai jun hua gong gong ying jian shui ji	88
济南力厚化工有限公司	ji nan li hou hua gong you xian gong si	92
济南市宇达高效混凝土减水剂厂	ji nan shi yu da gao xiao hun ning tu jian shui ji chang	87
济南市中建新外加剂厂	ji nan shi zhong jian xin wai jia ji chang	84
济南新宏基砼外加剂有限公司	ji nan xin hong ji tong wai jia ji you xian gong si	83
济南鑫利源化工有限公司联系人	ji nan xin li yuan hua gong you xian gong si lian xi ren	94
济南鑫龙海工贸有限公司	ji nan xin long hai gong mao you xian gong si	97
济南垚林建材有限公司	ji nan yao lin jian cai you xian gong si	95
济南正则科技发展有限公司	ji nan zheng ze ke ji fa zhan you xian gong si	81
济宁佳嘉建材有限公司	ji ning jia jia jian cai you xian gong si	9
济宁里能混凝土外加剂有限公司	ji ning li neng hun ning tu wai jia ji you xian gong si	11
济宁市市中区利建建筑外加剂厂	ji ning shi shi zhong qu li jian jian zhu wai jia ji chang	10
莱芜市明瑞化工有限公司	lai wu shi ming rui hua gong you xian gong si	12
莱芜市双泉建筑材料有限公司	lai wu shi shuang quan jian zhu cai liao you xian gong si	14
莱芜市仙山建材有限公司	lai wu shi xian shan jian cai you xian gong si	17
莱芜市兴业化工有限公司	lai wu shi xing ye hua gong you xian gong si	13
莱芜天成新型建材有限公司	lai wu tian cheng xin xing jian cai you xian gong si	15
莱芜新兴新材料有限公司	lai wu xin xing xin cai liao you xian gong si	20
莱芜亚诺化工有限公司	lai wu ya nuo hua gong you xian gong si	18
聊城市固而特外加剂有限公司	liao cheng shi gu er te wai jia ji you xian gong si	110
聊城市靳氏外加剂厂	liao cheng shi jin shi wai jia ji chang	109
临朐力原混凝土外加剂厂	lin qu li yuan hun ning tu wai jia ji chang	51
临沂宏特建材有限公司	lin yi hong te jian cai you xian gong si	21
临沂宏宇化工有限公司	lin yi hong yu hua gong you xian gong si	25
临沂市建强外加剂有限公司	lin yi shi jian qiang wai jia ji you xian gong si	24
临沂市鲁邦建材有限公司	lin yi shi lu bang jian cai you xian gong si	23
临沂市意顺化工有限公司	lin yi shi yi shun hua gong you xian gong si	26
青岛晨光化工有限公司	qing dao chen guang hua gong you xian gong si	66
青岛大润化工有限公司	qing dao da run hua gong you xian gong si	63
青岛德华源化工有限公司	qing dao de hua yuan hua gong you xian gong si	73
青岛福泰科技发展有限公司	qing dao fu tai ke ji fa zhan you xian gong si	57
青岛海利德外加剂建材厂	qing dao hai li de wai jia ji jian cai chang	56
青岛恒诚化工有限公司	qing dao heng cheng hua gong you xian gong si	60
青岛虹厦建材有限公司	qing dao hong sha jian cai you xian gong si	70
青岛黄河外加剂有限公司	qing dao huang he wai jia ji you xian gong si	59
青岛建磊新型建材有限公司	qing dao jian lei xin xing jian cai you xian gong si	58
青岛建特混凝土外加剂有限公司	qing dao jian te hun ning tu wai jia ji you xian gong si	61
青岛陆博建材有限公司	qing dao lu bo jian cai you xian gong si	55
青岛鹏鲲节能助剂厂	qing dao peng kun jie neng zhu ji chang	68
青岛青腾混凝土外加剂厂	qing dao qing teng hun ning tu wai jia ji chang	54
青岛市城阳区江源新型建材厂	qing dao shi cheng yang qu jiang yuan xin xing jian cai chang	67
青岛天塔新型建材有限公司	qing dao tian ta xin xing jian cai you xian gong si	65
青岛西岸建筑外加剂厂	qing dao xi an jian zhu wai jia ji chang	71
青岛鑫盛建材有限公司	qing dao xin sheng jian cai you xian gong si	72
青岛颐梅化学建材有限公司	qing dao yi mei hua xue jian cai you xian gong si	64
青岛中建瑞斯特建材有限公司	qing dao zhong jian rui si te jian cai you xian gong si	69
青岛筑友外加剂建材厂	qing dao zhu you wai jia ji jian cai chang	62
日照弗尔曼新材料科技有限公司	ri zhao fu er man xin cai liao ke ji you xian gong si	49
日照广信建材有限公司	ri zhao guang xin jian cai you xian gong si	48
日照昊宇新型建材有限公司	ri zhao hao yu xin xing jian cai you xian gong si	45
日照环海化工建材有限公司	ri zhao huan hai hua gong jian cai you xian gong si	47
日照市浩成化工有限公司	ri zhao shi hao cheng hua gong you xian gong si	46
日照市旭日建材有限公司	ri zhao shi xu ri jian cai you xian gong si	44
山东奥克利和矿产品有限公司	shan dong ao ke li he kuang chan pin you xian gong si	86
山东滨州高效减水剂厂	shan dong bin zhou gao xiao jian shui ji chang	101
山东博创建材有限公司	shan dong bo chuang jian cai you xian gong si	50
山东宏艺科技股份有限公司	shan dong hong yi ke ji gu fen you xian gong si	22
山东济南创新外加剂厂	shan dong ji nan chuang xin wai jia ji chang	82
山东济南豪建科技有限公司	shan dong ji nan hao jian ke ji you xian gong si	93
山东金岳混凝土外加剂有限公司	shan dong jin yue hun ning tu wai jia ji you xian gong si	79
山东鲁北海威混凝土外加剂厂	shan dong lu bei hai wei hun ning tu wai jia ji chang	99
山东省莱芜市恒正化工有限公司	shan dong sheng lai wu shi heng zheng hua gong you xian gong si	16
山东省莱芜市汶河化工	shan dong sheng lai wu shi wen he hua gong	19
山东同盛建材有限公司	shan dong tong sheng jian cai you xian gong si	53
山东枣庄华润化工有限公司	shan dong zao zhuang hua run hua gong you xian gong si	4
山东淄博鑫富达建材化工厂	shan dong zi bo xin fu da jian cai hua gong chang	42
泰安市东岳混凝土外加剂厂	tai an shi dong yue hun ning tu wai jia ji chang	3
泰安市新建助剂有限公司	tai an shi xin jian zhu ji you xian gong si	2
泰安市亚特尔化工建材有限公司	tai an shi ya te er hua gong jian cai you xian gong si	1
万山化工公司减水剂	wan shan hua gong gong si jian shui ji	52
威海云清新科技有限公司	wei hai yun qing xin ke ji you xian gong si	76
新中威建材有限公司青岛分公司	xin zhong wei jian cai you xian gong si qing dao fen gong si	75
烟台市孚混凝土外加剂有限公司	yan tai shi fu hun ning tu wai jia ji you xian gong si	31
烟台市芝罘区瓦克建材厂	yan tai shi zhi fu qu wa ke jian cai chang	28
烟台岩砂晶建材科技有限公司	yan tai yan sha jing jian cai ke ji you xian gong si	29
枣庄润泰外加剂建材有限公司	zao zhuang run tai wai jia ji jian cai you xian gong si	7
枣庄市台儿庄区鹏程砼外加剂厂	zao zhuang shi tai er zhuang qu peng cheng tong wai jia ji chang	6
枣庄市天石水泥外加剂有限公司	zao zhuang shi tian shi shui ni wai jia ji you xian gong si	8
枣庄沃德化工有限公司	zao zhuang wo de hua gong you xian gong si	5
章丘腾林减水剂制造有限公司	zhang qiu teng lin jian shui ji zhi zao you xian gong si	78
中元化工有限公司	zhong yuan hua gong you xian gong si	35
淄博华伟建材有限公司	zi bo hua wei jian cai you xian gong si	32
淄博建华建材有限公司	zi bo jian hua jian cai you xian gong si	36
淄博朋顺化工有限公司	zi bo peng shun hua gong you xian gong si	39
淄博市周村永超化工厂	zi bo shi zhou cun yong chao hua gong chang	43
淄博市淄川鑫汇减水剂厂	zi bo shi zi chuan xin hui jian shui ji chang	37
淄博双联建材有限公司	zi bo shuang lian jian cai you xian gong si	34
淄博伟广新型建材有限公司	zi bo wei guang xin xing jian cai you xian gong si	41
淄博显普化工有限公司	zi bo xian pu hua gong you xian gong si	40
淄博永超化工有限公司	zi bo yong chao hua gong you xian gong si	38
淄博永达化工厂	zi bo yong da hua gong chang	33
