# 文件名：带式输送机.scel
# 词库名：带式输送机
# 词库分类：机械工程
# 词库描述：
# 词条样例：带式输送机 胶带输送机 上海富运运输机械有限公司 上调心托辊 下调心托辊 平行下托辊
# 词条数量：16

带式输送机	dai shi shu song ji	16
导料槽防溢裙板	dao liao cao fang yi qun ban	5
电动机	dian dong ji	1
缓冲床	huan chong chuang	10
换带装置	huan dai zhuang zhi	6
胶带输送机	jiao dai shu song ji	15
逆止器	ni zhi qi	9
平行下托辊	ping xing xia tuo gun	11
清扫器	qing sao qi	2
柔性缓冲床	rou xing huan chong chuang	3
上海富运运输机械有限公司	shang hai fu yun yun shu ji xie you xian gong si	14
上调心托辊	shang tiao xin tuo gun	13
下调心托辊	xia tiao xin tuo gun	12
液力偶合器	ye li ou he qi	8
液压拉紧装置	ye ya la jin zhuang zhi	4
制动器	zhi dong qi	7
