# 文件名：干熄焦.scel
# 词库名：干熄焦
# 词库分类：钢铁冶金
# 词库描述：
# 词条样例：皮带机 装焦设备 电动闸板阀 干熄炉本体 排焦装置
# 词条数量：40

除尘风机	chu chen feng ji	7
除尘器	chu chen qi	6
除盐水箱	chu yan shui xiang	19
除氧器	chu yang qi	18
电动闸板阀	dian dong zha ban fa	29
对位装置	dui wei zhuang zhi	36
二次除尘器	er ci chu chen qi	21
发电机	fa dian ji	9
副省煤器	fu sheng mei qi	23
干熄焦	gan xi jiao	40
干熄焦本体设备	gan xi jiao ben ti she bei	33
干熄焦锅炉系统	gan xi jiao guo lu xi tong	2
干熄炉本体	gan xi lu ben ti	32
干熄炉鼓风装置	gan xi lu gu feng zhuang zhi	31
给水泵类设备	gei shui beng lei she bei	17
刮板机	gua ban ji	5
锅炉的主要功能	guo lu de zhu yao gong neng	14
锅炉的主要结构	guo lu de zhu yao jie gou	13
锅炉给水系统	guo lu gei shui xi tong	1
锅炉供水设备	guo lu gong shui she bei	20
环境除尘机及输灰设备	huan jing chu chen ji ji shu hui she bei	8
加湿机	jia shi ji	4
加药装置	jia yao zhuang zhi	16
焦罐台车	jiao guan tai che	38
排焦装置	pai jiao zhuang zhi	30
皮带机	pi dai ji	26
汽轮机	qi lun ji	10
气体循环设备	qi ti xun huan she bei	25
提升机	ti sheng ji	35
旋转焦罐	xuan zhuan jiao guan	37
旋转密封阀	xuan zhuan mi feng fa	27
循环风机	xun huan feng ji	24
一次除尘器	yi ci chu chen qi	22
余热锅炉	yu re guo lu	15
余热锅炉的日常点检及维护	yu re guo lu de ri chang dian jian ji wei hu	12
振动给料器	zhen dong gei liao qi	28
蒸汽发电设备	zheng qi fa dian she bei	11
正压输灰装置	zheng ya shu hui zhuang zhi	3
装焦设备	zhuang jiao she bei	39
装入装置	zhuang ru zhuang zhi	34
