# 文件名：建筑资料.scel
# 词库名：建筑资料
# 词库分类：理工类
# 词库描述：
# 词条样例：可行性报告审批意见 调查资料及项目评估研究材料 选址申请及选址规划意见通知书 拆迁安置意见协议方案等 划拨建设用地文件
# 词条数量：752

暗龙骨吊顶工程检验批质量验收记录表	an long gu diao ding gong cheng jian yan pi zhi liang yan shou ji lu biao	342
安全阀及报警联动系统动作测试记录	an quan fa ji bao jing lian dong xi tong dong zuo ce shi ji lu	230
安全阀减压阀的调试报告及定压合格证书厂家提供	an quan fa jian ya fa de tiao shi bao gao ji ding ya he ge zheng shu chang jia ti gong	279
安全阀门调试记录	an quan fa men tiao shi ji lu	261
安全防范综合管理系统分项工程质量验收记录表	an quan fang fan zong he guan li xi tong fen xiang gong cheng zhi liang yan shou ji lu biao	93
安全附件安装检查记录	an quan fu jian an zhuang jian cha ji lu	265
安装记录	an zhuang ji lu	255
八地基基础主体结构检验及抽样检测资料	ba di ji ji chu zhu ti jie gou jian yan ji chou yang jian ce zi liao	480
八工程质量控制的强制性条文	ba gong cheng zhi liang kong zhi de qiang zhi xing tiao wen	289
板材隔墙工程检验批质量验收记录表	ban cai ge qiang gong cheng jian yan pi zhi liang yan shou ji lu biao	339
报验申请表	bao yan shen qing biao	672
备用和不间断电源安装	bei yong he bu jian duan dian yuan an zhuang	121
避雷带支架拉力测试记录	bi lei dai zhi jia la li ce shi ji lu	165
避雷接地电阻测试记录	bi lei jie di dian zu ce shi ji lu	40
避雷引下线和变配电室接地干线敷设检验批质量验收记录表	bi lei yin xia xian he bian pei dian shi jie di gan xian fu she jian yan pi zhi liang yan shou ji lu biao	134
变配电室	bian pei dian shi	138
变配电系统分项工程质量验收记录表	bian pei dian xi tong fen xiang gong cheng zhi liang yan shou ji lu biao	76
变压器箱式变电所安装检验批质量验收记录表	bian ya qi xiang shi bian dian suo an zhuang jian yan pi zhi liang yan shou ji lu biao	137
裱糊工程检验批质量验收记录表	biao hu gong cheng jian yan pi zhi liang yan shou ji lu biao	323
裱糊用壁纸墙布产品合格证书性能检测报告	biao hu yong bi zhi qiang bu chan pin he ge zheng shu xing neng jian ce bao gao	577
裱糊与软包	biao hu yu ruan bao	324
玻璃产品合格证性能出厂检测报告	bo li chan pin he ge zheng xing neng chu chang jian ce bao gao	584
玻璃隔墙工程检验批质量验收记录表	bo li ge qiang gong cheng jian yan pi zhi liang yan shou ji lu biao	336
玻璃幕墙工程检验批质量验收记录表	bo li mu qiang gong cheng jian yan pi zhi liang yan shou ji lu biao	331
玻璃幕墙用结构胶邵式硬度拉伸粘结强度	bo li mu qiang yong jie gou jiao shao shi ying du la shen nian jie qiang du	572
补偿器安装记录	bu chang qi an zhuang ji lu	267
不发火防爆面层工程检验批质量验收记录表	bu fa huo fang bao mian ceng gong cheng jian yan pi zhi liang yan shou ji lu biao	359
不合格项处置记录	bu he ge xiang chu zhi ji lu	486
不间断电源安装检验批质量验收记录表	bu jian duan dian yuan an zhuang jian yan pi zhi liang yan shou ji lu biao	119
材料进场检验记录	cai liao jin chang jian yan ji lu	17
材料配件进场检验记录	cai liao pei jian jin chang jian yan ji lu	613
采暖系统试运行和调试记录	cai nuan xi tong shi yun xing he tiao shi ji lu	231
采暖与锅炉安装工程隐蔽记录	cai nuan yu guo lu an zhuang gong cheng yin bi ji lu	259
槽板配线检验批质量验收记录表	cao ban pei xian jian yan pi zhi liang yan shou ji lu biao	125
拆迁安置意见协议方案等	chai qian an zhi yi jian xie yi fang an deng	740
柴油发电机组安装检验批质量验收记录表	chai you fa dian ji zu an zhuang jian yan pi zhi liang yan shou ji lu biao	120
敞开水箱满水试验记录	chang kai shui xiang man shui shi yan ji lu	233
沉井沉箱工程检验批质量验收记录表	chen jing chen xiang gong cheng jian yan pi zhi liang yan shou ji lu biao	453
衬砌裂缝注浆检验批质量验收记录表	chen qi lie feng zhu jiang jian yan pi zhi liang yan shou ji lu biao	420
程控电话交换系统分项工程质量验收记录表	cheng kong dian hua jiao huan xi tong fen xiang gong cheng zhi liang yan shou ji lu biao	66
成品伸缩器预拉伸记录厂家提供	cheng pin shen suo qi yu la shen ji lu chang jia ti gong	283
成套电柜控制柜屏台和动力照明配电箱盘安装检验批质量验收记录表	cheng tao dian gui kong zhi gui ping tai he dong li zhao ming pei dian xiang pan an zhuang jian yan pi zhi liang yan shou ji lu biao	126
成套配电柜控制柜屏台和动力照明配电箱盘安装检验批质量验收记录表	cheng tao pei dian gui kong zhi gui ping tai he dong li zhao ming pei dian xiang pan an zhuang jian yan pi zhi liang yan shou ji lu biao	145
承压管道系统设备强度和严密水压试验记录	cheng ya guan dao xi tong she bei qiang du he yan mi shui ya shi yan ji lu	241
重复接地防雷接地工程隐蔽验收记录	chong fu jie di fang lei jie di gong cheng yin bi yan shou ji lu	156
抽气风道检查记录	chou qi feng dao jian cha ji lu	49
初步设计图及说明	chu bu she ji tu ji shuo ming	728
橱柜制作与安装工程检验批质量验收记录表	chu gui zhi zuo yu an zhuang gong cheng jian yan pi zhi liang yan shou ji lu biao	320
出入口控制门禁系统分项工程质量验收记录表	chu ru kou kong zhi men jin xi tong fen xiang gong cheng zhi liang yan shou ji lu biao	90
穿墙管止水环与主管或翼环与套管隐蔽验收记录	chuan qiang guan zhi shui huan yu zhu guan huo yi huan yu tao guan yin bi yan shou ji lu	529
窗帘盒窗台板和散热器罩制作与安装工程检验批质量验收记录表	chuang lian he chuang tai ban he san re qi zhao zhi zuo yu an zhuang gong cheng jian yan pi zhi liang yan shou ji lu biao	319
吹冲洗脱脂试验记录	chui chong xi tuo zhi shi yan ji lu	269
大理石和花岗石面层工程检验批质量验收记录表	da li shi he hua gang shi mian ceng gong cheng jian yan pi zhi liang yan shou ji lu biao	357
大容量电气线路结点测温记录	da rong liang dian qi xian lu jie dian ce wen ji lu	166
大容量及以上导线或母线连接处负荷运行温度测试记录	da rong liang ji yi shang dao xian huo mu xian lian jie chu fu he yun xing wen du ce shi ji lu	161
大体积混凝土测温记录表	da ti ji hun ning tu ce wen ji lu biao	501
大型灯具牢固性试验记录	da xing deng ju lao gu xing shi yan ji lu	41
大型照明灯具承载试验记录	da xing zhao ming deng ju cheng zai shi yan ji lu	169
单层钢构件安装工程检验批质量验收记录表	dan ceng gang gou jian an zhuang gong cheng jian yan pi zhi liang yan shou ji lu biao	387
单位工程竣工预验收报验单	dan wei gong cheng jun gong yu yan shou bao yan dan	678
单位子单位工程安全和功能检验资料核查及主要功能抽查记录	dan wei zi dan wei gong cheng an quan he gong neng jian yan zi liao he cha ji zhu yao gong neng chou cha ji lu	29
单位子单位工程观感质量检查记录	dan wei zi dan wei gong cheng guan gan zhi liang jian cha ji lu	28
单位子单位工程竣工验收报告	dan wei zi dan wei gong cheng jun gong yan shou bao gao	14
单位子单位工程质量竣工验收记录	dan wei zi dan wei gong cheng zhi liang jun gong yan shou ji lu	31
单位子单位工程质量控制资料核查记录	dan wei zi dan wei gong cheng zhi liang kong zhi zi liao he cha ji lu	30
导管电缆桥架和线槽出厂合格证	dao guan dian lan qiao jia he xian cao chu chang he ge zheng	179
导线点水准点测量复核记录	dao xian dian shui zhun dian ce liang fu he ji lu	616
地表土壤氡浓度检测报告	di biao tu rang dong nong du jian ce bao gao	536
第二部分工程质量控制资料	di er bu fen gong cheng zhi liang kong zhi zi liao	630
第二分部给排水与采暖	di er fen bu ji pai shui yu cai nuan	295
地基处理	di ji chu li	451
地基处理记录	di ji chu li ji lu	512
地基基础工程各规范强制性条检查记录表	di ji ji chu gong cheng ge gui fan qiang zhi xing tiao jian cha ji lu biao	302
地基基础主体结构检验及抽样检测汇总表	di ji ji chu zhu ti jie gou jian yan ji chou yang jian ce hui zong biao	479
地基检测报告	di ji jian ce bao gao	477
地基钎探记录	di ji qian tan ji lu	511
地基验槽检查记录	di ji yan cao jian cha ji lu	513
地基与基础	di ji yu ji chu	465
地基与基础工程验收表	di ji yu ji chu gong cheng yan shou biao	1
第六分部智能建筑	di liu fen bu zhi neng jian zhu	111
地漏排水试验记录	di lou pai shui shi yan ji lu	237
地面	di mian	374
地面材料产品合格证性能检测报告	di mian cai liao chan pin he ge zheng xing neng jian ce bao gao	575
第三部分单位子单位工程安全和功能检验资料	di san bu fen dan wei zi dan wei gong cheng an quan he gong neng jian yan zi liao	54
第三分部电气	di san fen bu dian qi	43
第三分部建筑电气	di san fen bu jian zhu dian qi	188
第四部分工程竣工资料	di si bu fen gong cheng jun gong zi liao	32
第四分部通风与空调	di si fen bu tong feng yu kong tiao	113
低温热水地板辐射采暖系统安装工程检验批质量验收记录表	di wen re shui de ban fu she cai nuan xi tong an zhuang gong cheng jian yan pi zhi liang yan shou ji lu biao	208
第五分部电梯	di wu fen bu dian ti	112
地下防水	di xia fang shui	435
地下防水转角处变形缝穿墙管道后浇带埋设件施工缝等细部做法隐蔽验收记录	di xia fang shui zhuan jiao chu bian xing feng chuan qiang guan dao hou jiao dai mai she jian shi gong feng deng xi bu zuo fa yin bi yan shou ji lu	530
地下工程防水试水检查记录	di xia gong cheng fang shui shi shui jian cha ji lu	498
地下连续墙槽段接缝及墙体与内衬结构接缝隐蔽验收记录	di xia lian xu qiang cao duan jie feng ji qiang ti yu nei chen jie gou jie feng yin bi yan shou ji lu	528
地下连续墙工程检验批质量验收记录表	di xia lian xu qiang gong cheng jian yan pi zhi liang yan shou ji lu biao	456
地下连续墙检验批质量验收记录表	di xia lian xu qiang jian yan pi zhi liang yan shou ji lu biao	425
地下室防水效果检查记录	di xia shi fang shui xiao guo jian cha ji lu	52
地下屋面防水工程规范强制性条检查记录表	di xia wu mian fang shui gong cheng gui fan qiang zhi xing tiao jian cha ji lu biao	297
低压成套配电框动力照明配电箱盘框出厂合格证及技术文件	di ya cheng tao pei dian kuang dong li zhao ming pei dian xiang pan kuang chu chang he ge zheng ji ji shu wen jian	184
低压电动机电加热器及电动执行机构检查接线检验批质量验收记录表	di ya dian dong ji dian jia re qi ji dian dong zhi xing ji gou jian cha jie xian jian yan pi zhi liang yan shou ji lu biao	130
低压电气动力设备试验和试运行检验批质量验收记录表	di ya dian qi dong li she bei shi yan he shi yun xing jian yan pi zhi liang yan shou ji lu biao	129
第一部分施工技术管理资料	di yi bu fen shi gong ji shu guan li zi liao	642
第一分部建筑与结构	di yi fen bu jian zhu yu jie gou	629
电导管安装隐蔽验收记录	dian dao guan an zhuang yin bi yan shou ji lu	158
电导管内穿线隐蔽验收记录	dian dao guan nei chuan xian yin bi yan shou ji lu	157
电动机电加热器电动执行机构和低压开并设备合格证及技术文件	dian dong ji dian jia re qi dian dong zhi xing ji gou he di ya kai bing she bei he ge zheng ji ji shu wen jian	182
电度表检定记录	dian du biao jian ding ji lu	167
电缆沟内和电缆竖井内电缆敷设检验批质量验收记录表	dian lan gou nei he dian lan shu jing nei dian lan fu she jian yan pi zhi liang yan shou ji lu biao	135
电缆桥架安装和桥架内电缆敷设检验批质量验收记录表	dian lan qiao jia an zhuang he qiao jia nei dian lan fu she jian yan pi zhi liang yan shou ji lu biao	132
电缆头制作接线和线路绝缘测试检验批质量验收记录表	dian lan tou zhi zuo jie xian he xian lu jue yuan ce shi jian yan pi zhi liang yan shou ji lu biao	142
电力变压器柴油发电机组高压成套配电框蓄电池框不间断电源框控制框屏台出厂合格证及技术文件	dian li bian ya qi chai you fa dian ji zu gao ya cheng tao pei dian kuang xu dian chi kuang bu jian duan dian yuan kuang kong zhi kuang ping tai chu chang he ge zheng ji ji shu wen jian	183
电气动力	dian qi dong li	131
电气防雷接地装置隐检与平面示意图	dian qi fang lei jie di zhuang zhi yin jian yu ping mian shi yi tu	159
电气工程规范强制性条检查记录表	dian qi gong cheng gui fan qiang zhi xing tiao jian cha ji lu biao	114
电气接地电阻测试记录	dian qi jie di dian zu ce shi ji lu	162
电气器具通电安全检查记录	dian qi qi ju tong dian an quan jian cha ji lu	172
电气设备交接试验记录	dian qi she bei jiao jie shi yan ji lu	154
电气设备空载负荷试运行记录	dian qi she bei kong zai fu he shi yun xing ji lu	171
电气设备空载试运行记录	dian qi she bei kong zai shi yun xing ji lu	152
电气设备试验调整记录	dian qi she bei shi yan tiao zheng ji lu	19
电气照明安装	dian qi zhao ming an zhuang	127
电梯和自动扶梯系统分项工程质量验收记录	dian ti he zi dong fu ti xi tong fen xiang gong cheng zhi liang yan shou ji lu	81
电梯运行记录	dian ti yun xing ji lu	34
电线导管电缆导管和线槽敷设检验批质量验收记录表	dian xian dao guan dian lan dao guan he xian cao fu she jian yan pi zhi liang yan shou ji lu biao	144
电线电缆出厂合格证及技术文件	dian xian dian lan chu chang he ge zheng ji ji shu wen jian	180
电线电缆穿管和线槽敷设检验批质量验收记录表	dian xian dian lan chuan guan he xian cao fu she jian yan pi zhi liang yan shou ji lu biao	143
电源系统分项工程质量验收记录表	dian yuan xi tong fen xiang gong cheng zhi liang yan shou ji lu biao	101
调查资料及项目评估研究材料	diao cha zi liao ji xiang mu ping gu yan jiu cai liao	743
吊顶	diao ding	343
吊顶隔墙细部龙骨产品合格证出厂检测报告	diao ding ge qiang xi bu long gu chan pin he ge zheng chu chang jian ce bao gao	587
吊顶工程隐蔽验收记录	diao ding gong cheng yin bi yan shou ji lu	523
镀锌制品支架横担接地级避雷用型钢等和外线金具合格证和镀锌质量证明	du xin zhi pin zhi jia heng dan jie di ji bi lei yong xing gang deng he wai xian jin ju he ge zheng he du xin zhi liang zheng ming	177
盾构法隧道检验批质量验收记录表	dun gou fa sui dao jian yan pi zhi liang yan shou ji lu biao	424
多层及高层钢构件安装工程检验批质量验收记录表	duo ceng ji gao ceng gang gou jian an zhuang gong cheng jian yan pi zhi liang yan shou ji lu biao	386
二材料配件出厂合格证书及进场检验报告	er cai liao pei jian chu chang he ge zheng shu ji jin chang jian yan bao gao	288
二材料配件出厂合格证书及进场验报告	er cai liao pei jian chu chang he ge zheng shu ji jin chang yan bao gao	294
二工程定位测量放线验收记录	er gong cheng ding wei ce liang fang xian yan shou ji lu	620
阀门散热器安装前水压试验记录	fa men san re qi an zhuang qian shui ya shi yan ji lu	242
阀门压力试验表	fa men ya li shi yan biao	260
反循环桩施工验收记录	fan xun huan zhuang shi gong yan shou ji lu	3
防腐涂料装工程检验批质量验收记录表	fang fu tu liao zhuang gong cheng jian yan pi zhi liang yan shou ji lu biao	404
防火涂料涂装工程检验批质量验收记录表	fang huo tu liao tu zhuang gong cheng jian yan pi zhi liang yan shou ji lu biao	403
防雷及接地安装	fang lei ji jie di an zhuang	118
防雷与接地系统分项工程质量验收记录表	fang lei yu jie di xi tong fen xiang gong cheng zhi liang yan shou ji lu biao	102
防水材料合格证复试报告汇总表	fang shui cai liao he ge zheng fu shi bao gao hui zong biao	568
防水材料合格证复试报告及进场检验记录	fang shui cai liao he ge zheng fu shi bao gao ji jin chang jian yan ji lu	566
防水材料合格证书复试报告汇总表	fang shui cai liao he ge zheng shu fu shi bao gao hui zong biao	567
防水工程试水检查记录	fang shui gong cheng shi shui jian cha ji lu	497
防水混凝土检验批质量验收记录表	fang shui hun ning tu jian yan pi zhi liang yan shou ji lu biao	434
防油渗面层检验批质量验收记录表	fang you shen mian ceng jian yan pi zhi liang yan shou ji lu biao	360
非压力管通水试验记录	fei ya li guan tong shui shi yan ji lu	240
费用索赔审批表	fei yong suo pei shen pi biao	660
费用索赔申请表	fei yong suo pei shen qing biao	668
分包单位资质报审表	fen bao dan wei zi zhi bao shen biao	673
分部工程验收记录	fen bu gong cheng yan shou ji lu	12
分部子分部工程质量验收记录	fen bu zi fen bu gong cheng zhi liang yan shou ji lu	312
粉煤灰地基工程检验批质量验收记录表	fen mei hui di ji gong cheng jian yan pi zhi liang yan shou ji lu biao	447
分项工程质量验收记录	fen xiang gong cheng zhi liang yan shou ji lu	314
封闭母线插接母线合格证安装技术文件	feng bi mu xian cha jie mu xian he ge zheng an zhuang ji shu wen jian	176
风量温度测量记录	feng liang wen du ce liang ji lu	37
复合式衬砌检验批质量验收记录表	fu he shi chen qi jian yan pi zhi liang yan shou ji lu biao	426
钢材出厂合格证书和复试报告汇总表	gang cai chu chang he ge zheng shu he fu shi bao gao hui zong biao	611
钢材合格证书和复试报告汇总表	gang cai he ge zheng shu he fu shi bao gao hui zong biao	612
钢构件预拼装工程检验批质量验收记录表	gang gou jian yu pin zhuang gong cheng jian yan pi zhi liang yan shou ji lu biao	384
钢构件组装工程检验批质量验收记录表	gang gou jian zu zhuang gong cheng jian yan pi zhi liang yan shou ji lu biao	385
钢管伸缩器预拉伸安装记录	gang guan shen suo qi yu la shen an zhuang ji lu	249
钢或混凝土支撑工程检验批质量验收记录表	gang huo hun ning tu zhi cheng gong cheng jian yan pi zhi liang yan shou ji lu biao	452
钢结构	gang jie gou	409
钢结构工程各规范强制性条检查记录表	gang jie gou gong cheng ge gui fan qiang zhi xing tiao jian cha ji lu biao	300
钢结构零部件加工工程检验批质量验收记录表	gang jie gou ling bu jian jia gong gong cheng jian yan pi zhi liang yan shou ji lu biao	389
钢结构施工记录	gang jie gou shi gong ji lu	493
钢结构制作焊接工程检验批质量验收记录表	gang jie gou zhi zuo han jie gong cheng jian yan pi zhi liang yan shou ji lu biao	408
钢筋安装工程检验批质量验收记录表	gang jin an zhuang gong cheng jian yan pi zhi liang yan shou ji lu biao	414
钢筋保护层厚度实测表	gang jin bao hu ceng hou du shi ce biao	478
钢筋工程隐蔽验收记录	gang jin gong cheng yin bi yan shou ji lu	532
钢筋合格证书及进场检验报告	gang jin he ge zheng shu ji jin chang jian yan bao gao	610
钢筋加工检验批质量验收记录表	gang jin jia gong jian yan pi zhi liang yan shou ji lu biao	415
钢筋连接试验报告	gang jin lian jie shi yan bao gao	541
钢筋连接试验报告焊条合格证	gang jin lian jie shi yan bao gao han tiao he ge zheng	544
钢筋连接试验报告焊条合格证汇总表	gang jin lian jie shi yan bao gao han tiao he ge zheng hui zong biao	543
钢索配线检验批质量验收记录表	gang suo pei xian jian yan pi zhi liang yan shou ji lu biao	124
钢网架安装工程检验批质量验收记录表	gang wang jia an zhuang gong cheng jian yan pi zhi liang yan shou ji lu biao	383
钢网架制作工程检验批质量验收记录表	gang wang jia zhi zuo gong cheng jian yan pi zhi liang yan shou ji lu biao	388
刚性防水屋面	gang xing fang shui wu mian	306
钢桩成品工程检验批质量验收记录表	gang zhuang cheng pin gong cheng jian yan pi zhi liang yan shou ji lu biao	438
钢桩施工检验批质量验收记录表	gang zhuang shi gong jian yan pi zhi liang yan shou ji lu biao	437
高强度螺栓连接工程检验批质量验收记录表	gao qiang du luo shuan lian jie gong cheng jian yan pi zhi liang yan shou ji lu biao	405
高压部分试验记录	gao ya bu fen shi yan ji lu	173
隔离层检验批质量验收记录表	ge li ceng jian yan pi zhi liang yan shou ji lu biao	365
隔墙吊顶细部面板产品合格证出厂检测报告	ge qiang diao ding xi bu mian ban chan pin he ge zheng chu chang jian ce bao gao	586
隔热屋面	ge re wu mian	304
给排水系统分项工程质量验收记录表	gei pai shui xi tong fen xiang gong cheng zhi liang yan shou ji lu biao	78
给水系统消毒检测记录	gei shui xi tong xiao du jian ce ji lu	235
更改审核表	geng gai shen he biao	57
工程安装质量及观感质量验收记录	gong cheng an zhuang zhi liang ji guan gan zhi liang yan shou ji lu	58
工程变更单	gong cheng bian geng dan	658
工程材料构配件设备报审表	gong cheng cai liao gou pei jian she bei bao shen biao	667
工程地质勘察报告	gong cheng di zhi kan cha bao gao	735
工程定位高程测量记录	gong cheng ding wei gao cheng ce liang ji lu	619
工程概况	gong cheng gai kuang	641
工程概况表	gong cheng gai kuang biao	20
工程结决算书	gong cheng jie jue suan shu	697
工程竣工报验表	gong cheng jun gong bao yan biao	666
工程竣工图	gong cheng jun gong tu	23
工程竣工验收报告市站	gong cheng jun gong yan shou bao gao shi zhan	13
工程竣工总结	gong cheng jun gong zong jie	694
工程开工复工报审表	gong cheng kai gong fu gong bao shen biao	675
工程开工施工竣工的录音录象资料	gong cheng kai gong shi gong jun gong de lu yin lu xiang zi liao	692
工程款支付申请表	gong cheng kuan zhi fu shen qing biao	671
工程款支付证书	gong cheng kuan zhi fu zheng shu	663
工程临时延期审批表	gong cheng lin shi yan qi shen pi biao	662
工程临时延期申请表	gong cheng lin shi yan qi shen qing biao	669
工程设计概算	gong cheng she ji gai suan	700
工程投资估算文件	gong cheng tou zi gu suan wen jian	701
工程未开工前原貌竣工新貌照片	gong cheng wei kai gong qian yuan mao jun gong xin mao zhao pian	693
工程项目施工管理人员名单	gong cheng xiang mu shi gong guan li ren yuan ming dan	640
工程预决算书	gong cheng yu jue suan shu	633
工程暂停令	gong cheng zan ting ling	664
工程招标及承包合同文件	gong cheng zhao biao ji cheng bao he tong wen jian	723
工程质量保修书	gong cheng zhi liang bao xiu shu	24
工程质量监督手续	gong cheng zhi liang jian du shou xu	712
工程质量事故调查处理资料	gong cheng zhi liang shi gu diao cha chu li zi liao	471
工程质量事故情况报告	gong cheng zhi liang shi gu qing kuang bao gao	472
工程轴线定位桩高程测量复核记录	gong cheng zhou xian ding wei zhuang gao cheng ce liang fu he ji lu	615
工程准备阶段文件与资料	gong cheng zhun bei jie duan wen jian yu zi liao	751
工程总承包合同及分包合同	gong cheng zong cheng bao he tong ji fen bao he tong	634
工程最终延期审批表	gong cheng zui zhong yan qi shen pi biao	661
工地现场协调例会记录	gong di xian chang xie tiao li hui ji lu	625
供电干线	gong dian gan xian	133
公共广播与紧急广播系统分项工程质量验收记录表	gong gong guang bo yu jin ji guang bo xi tong fen xiang gong cheng zhi liang yan shou ji lu biao	71
公共照明系统分项工程质量验收记录表	gong gong zhao ming xi tong fen xiang gong cheng zhi liang yan shou ji lu biao	77
供热锅炉及辅助设备安装	gong re guo lu ji fu zhu she bei an zhuang	196
公司表格	gong si biao ge	21
工序交接单	gong xu jiao jie dan	487
工序交接合格施工安装记录格式施工单位自备	gong xu jiao jie he ge shi gong an zhuang ji lu ge shi shi gong dan wei zi bei	151
工艺管道安装工程检验批质量验收记录表	gong yi guan dao an zhuang gong cheng jian yan pi zhi liang yan shou ji lu biao	193
构件吊装记录	gou jian diao zhuang ji lu	500
骨架隔墙工程检验批质量验收记录表	gu jia ge qiang gong cheng jian yan pi zhi liang yan shou ji lu biao	338
管材管件卫生检验报告	guan cai guan jian wei sheng jian yan bao gao	253
管材及配件的产品质量证明文件检测报告	guan cai ji pei jian de chan pin zhi liang zheng ming wen jian jian ce bao gao	287
管道保温记录	guan dao bao wen ji lu	246
管道焊接检验记录	guan dao han jie jian yan ji lu	254
管沟及井室检验批工程质量验收记录表	guan gou ji jing shi jian yan pi gong cheng zhi liang yan shou ji lu biao	204
灌满水试验记录	guan man shui shi yan ji lu	272
关于立项有关的会议纪要领导批示	guan yu li xiang you guan de hui yi ji yao ling dao pi shi	745
规划设计条件通知书及	gui hua she ji tiao jian tong zhi shu ji	731
硅酮结构胶认定证书合格证书进口硅酮结构胶的商检证	gui tong jie gou jiao ren ding zheng shu he ge zheng shu jin kou gui tong jie gou jiao de shang jian zheng	573
锅炉安全附件安装工程检验批质量验收记录表	guo lu an quan fu jian an zhuang gong cheng jian yan pi zhi liang yan shou ji lu biao	192
锅炉安装工程检验批质量验收记录表	guo lu an zhuang gong cheng jian yan pi zhi liang yan shou ji lu biao	195
锅炉封闭及烘炉烘干记录	guo lu feng bi ji hong lu hong gan ji lu	264
锅炉负荷试运行记录	guo lu fu he shi yun xing ji lu	229
锅炉辅助设备安装工程检验批质量验收记录表	guo lu fu zhu she bei an zhuang gong cheng jian yan pi zhi liang yan shou ji lu biao	194
锅炉烘炉记录	guo lu hong lu ji lu	244
锅炉及压力容器焊缝无损探伤检测报告	guo lu ji ya li rong qi han feng wu sun tan shang jian ce bao gao	281
锅炉试运行记录	guo lu shi yun xing ji lu	262
锅炉煮炉试验记录	guo lu zhu lu shi yan ji lu	243
国有土地使用证	guo you tu di shi yong zheng	737
焊钉焊接工程检验批质量验收记录表	han ding han jie gong cheng jian yan pi zhi liang yan shou ji lu biao	407
焊接材料烘焙记录	han jie cai liao hong bei ji lu	499
焊条合格证	han tiao he ge zheng	542
夯扩桩施工记录表	hang kuo zhuang shi gong ji lu biao	10
合同约定由建设单位采购的材料构配件和设备的质量证明文件及进场报验文件	he tong yue ding you jian she dan wei cai gou de cai liao gou pei jian he she bei de zhi liang zheng ming wen jian ji jin chang bao yan wen jian	695
护栏和扶手制作与安装工程检验批质量验收记录表	hu lan he fu shou zhi zuo yu an zhuang gong cheng jian yan pi zhi liang yan shou ji lu biao	317
护栏与预埋件的连接节点预埋件隐蔽验收记录	hu lan yu yu mai jian de lian jie jie dian yu mai jian yin bi yan shou ji lu	520
划拨建设用地文件	hua bo jian she yong di wen jian	738
花饰制作与安装工程检验批质量验收记录表	hua shi zhi zuo yu an zhuang gong cheng jian yan pi zhi liang yan shou ji lu biao	316
环境检测分项工程质量验收记录表	huan jing jian ce fen xiang gong cheng zhi liang yan shou ji lu biao	103
换热站安装工程检验批质量验收记录表	huan re zhan an zhuang gong cheng jian yan pi zhi liang yan shou ji lu biao	191
灰土地基工程检验批质量验收记录表	hui tu di ji gong cheng jian yan pi zhi liang yan shou ji lu biao	450
灰土垫层检验批质量验收记录表	hui tu dian ceng jian yan pi zhi liang yan shou ji lu biao	372
会议电视系统分项工程质量验收记录表	hui yi dian shi xi tong fen xiang gong cheng zhi liang yan shou ji lu biao	67
混凝土拆模申请单	hun ning tu chai mo shen qing dan	504
混凝土灌注工程检验批质量验收记录表	hun ning tu guan zhu gong cheng jian yan pi zhi liang yan shou ji lu biao	457
混凝土灌注桩工程检验批质量验收记录表	hun ning tu guan zhu zhuang gong cheng jian yan pi zhi liang yan shou ji lu biao	436
混凝土基础	hun ning tu ji chu	419
混凝土搅拌测温记录	hun ning tu jiao ban ce wen ji lu	503
混凝土浇灌申请书	hun ning tu jiao guan shen qing shu	507
混凝土结构	hun ning tu jie gou	401
混凝土结构工程各规范强制性条检查记录表	hun ning tu jie gou gong cheng ge gui fan qiang zhi xing tiao jian cha ji lu biao	301
混凝土开盘鉴定	hun ning tu kai pan jian ding	505
混凝土配合比通知单	hun ning tu pei he bi tong zhi dan	559
混凝土砂浆试块制作记录表	hun ning tu sha jiang shi kuai zhi zuo ji lu biao	16
混凝土设备基础外观及尺寸偏差检验批质量验收记录表	hun ning tu she bei ji chu wai guan ji chi cun pian cha jian yan pi zhi liang yan shou ji lu biao	410
混凝土施工检验批质量验收记录表	hun ning tu shi gong jian yan pi zhi liang yan shou ji lu biao	412
混凝土小型空心砌块体工程检验批质量验收记录表	hun ning tu xiao xing kong xin qi kuai ti gong cheng jian yan pi zhi liang yan shou ji lu biao	393
混凝土养护测温记录表	hun ning tu yang hu ce wen ji lu biao	502
混凝土预制桩钢筋骨架工程检验批质量验收记录表	hun ning tu yu zhi zhuang gang jin gu jia gong cheng jian yan pi zhi liang yan shou ji lu biao	440
混凝土预制桩工程检验批质量验收记录表	hun ning tu yu zhi zhuang gong cheng jian yan pi zhi liang yan shou ji lu biao	439
混凝土原材料及配合比设计检验批质量验收记录表	hun ning tu yuan cai liao ji pei he bi she ji jian yan pi zhi liang yan shou ji lu biao	413
活动隔墙工程检验批质量验收记录表	huo dong ge qiang gong cheng jian yan pi zhi liang yan shou ji lu biao	337
火灾自动报警及消防联动系统分项工程质量验收记录表	huo zai zi dong bao jing ji xiao fang lian dong xi tong fen xiang gong cheng zhi liang yan shou ji lu biao	86
基槽开挖测量记录	ji cao kai wa ce liang ji lu	618
基坑支护变形监测报告	ji keng zhi hu bian xing jian ce bao gao	474
季年检登记表	ji nian jian deng ji biao	110
技术核定单	ji shu he ding dan	622
技术交底记录	ji shu jiao di ji lu	621
给水管道材料卫生检测报告	ji shui guan dao cai liao wei sheng jian ce bao gao	284
给水管通水试验	ji shui guan tong shui shi yan	47
给水排水及采暖工程规范强制性条检查记录表	ji shui pai shui ji cai nuan gong cheng gui fan qiang zhi xing tiao jian cha ji lu biao	189
给水排水系统及卫生器具交付使用前通水试验记录	ji shui pai shui xi tong ji wei sheng qi ju jiao fu shi yong qian tong shui shi yan ji lu	234
给水热水及采暖管道系统冲洗记录	ji shui re shui ji cai nuan guan dao xi tong chong xi ji lu	239
给水设备安装工程检验批质量验收记录表	ji shui she bei an zhuang gong cheng jian yan pi zhi liang yan shou ji lu biao	221
计算机网络系统检测分项工程质量验收记录表	ji suan ji wang luo xi tong jian ce fen xiang gong cheng zhi liang yan shou ji lu biao	72
基土垫层检验批质量验收记录表	ji tu dian ceng jian yan pi zhi liang yan shou ji lu biao	373
机械成孔灌注桩施工检查记录	ji xie cheng kong guan zhu zhuang shi gong jian cha ji lu	509
加筋水泥土桩墙支护工程检验批质量验收记录表	jia jin shui ni tu zhuang qiang zhi hu gong cheng jian yan pi zhi liang yan shou ji lu biao	454
监报验申请表	jian bao yan shen qing biao	653
监承包单位通用申报表	jian cheng bao dan wei tong yong shen bao biao	644
监费用索赔申请表	jian fei yong suo pei shen qing biao	649
监分包单位资格报审表	jian fen bao dan wei zi ge bao shen biao	654
监工程材料构配件设备报审表	jian gong cheng cai liao gou pei jian she bei bao shen biao	648
监工程竣工报验单	jian gong cheng jun gong bao yan dan	647
监工程开工复工报审表	jian gong cheng kai gong fu gong bao shen biao	656
监工程款支付申请表	jian gong cheng kuan zhi fu shen qing biao	652
监工程临时延期申请表	jian gong cheng lin shi yan qi shen qing biao	650
监混凝土浇筑申报表	jian hun ning tu jiao zhu shen bao biao	646
监监理工程师通知回复单	jian jian li gong cheng shi tong zhi hui fu dan	651
监理工程师通知单	jian li gong cheng shi tong zhi dan	665
监理工程师通知回复单	jian li gong cheng shi tong zhi hui fu dan	670
监理工作联系单	jian li gong zuo lian xi dan	659
监理工作日志	jian li gong zuo ri zhi	685
监理工作总结监理旁站记录	jian li gong zuo zong jie jian li pang zhan ji lu	684
监理管理资料	jian li guan li zi liao	690
监理规范表格	jian li gui fan biao ge	676
监理规划	jian li gui hua	689
监理会议纪要	jian li hui yi ji yao	686
监理机构项目组织机构及负责人	jian li ji gou xiang mu zu zhi ji gou ji fu ze ren	707
监理机构资质证书及相关人员资格证书	jian li ji gou zi zhi zheng shu ji xiang guan ren yuan zi ge zheng shu	703
监理实施细则	jian li shi shi xi ze	688
监理月报	jian li yue bao	687
监理招投标文件及监理合同	jian li zhao tou biao wen jian ji jian li he tong	719
监理资料	jian li zi liao	691
建设单位项目组织机构及负责人	jian she dan wei xiang mu zu zhi ji gou ji fu ze ren	710
建设工程规划许可证及附件	jian she gong cheng gui hua xu ke zheng ji fu jian	715
建设工程施工许可证	jian she gong cheng shi gong xu ke zheng	714
建设工程质量事故调勘查记录	jian she gong cheng zhi liang shi gu tiao kan cha ji lu	470
建设施工监理单位资质证明和负责人	jian she shi gong jian li dan wei zi zhi zheng ming he fu ze ren	711
建设项目列入年度计划的批复文件或年度计划项目表	jian she xiang mu lie ru nian du ji hua de pi fu wen jian huo nian du ji hua xiang mu biao	716
建设项目列入年度计划的申报文件	jian she xiang mu lie ru nian du ji hua de shen bao wen jian	717
建设用地规划许可证及附件	jian she yong di gui hua xu ke zheng ji fu jian	739
建设用地征地拆迁文件	jian she yong di zheng di chai qian wen jian	742
监施工测量放线报验单	jian shi gong ce liang fang xian bao yan dan	645
监施工组织设计报审表	jian shi gong zu zhi she ji bao shen biao	655
检验批质量验收记录表	jian yan pi zhi liang yan shou ji lu biao	313
见证记录	jian zheng ji lu	679
见证取样和送检计划	jian zheng qu yang he song jian ji hua	680
见证取样和送检见证人备案书	jian zheng qu yang he song jian jian zheng ren bei an shu	681
见证取样送检见证人授权书	jian zheng qu yang song jian jian zheng ren shou quan shu	632
建筑电气分部工程质量竣工验收记录	jian zhu dian qi fen bu gong cheng zhi liang jun gong yan shou ji lu	150
建筑电气工程质量检验批	jian zhu dian qi gong cheng zhi liang jian yan pi	149
建筑工程资料目录	jian zhu gong cheng zi liao mu lu	752
建筑给水排水及采暖	jian zhu ji shui pai shui ji cai nuan	225
建筑给水排水及采暖分部工程质量竣工验收记录	jian zhu ji shui pai shui ji cai nuan fen bu gong cheng zhi liang jun gong yan shou ji lu	226
建筑物垂直度标高全高测量记录	jian zhu wu chui zhi du biao gao quan gao ce liang ji lu	50
建筑物等电位联结检验批质量验收记录表	jian zhu wu deng dian wei lian jie jian yan pi zhi liang yan shou ji lu biao	117
建筑物景观照明灯航空障碍标志灯和庭院灯安装检验批质量验收记录表	jian zhu wu jing guan zhao ming deng hang kong zhang ai biao zhi deng he ting yuan deng an zhuang jian yan pi zhi liang yan shou ji lu biao	141
建筑屋面	jian zhu wu mian	315
建筑物照明通电试运行记录	jian zhu wu zhao ming tong dian shi yun xing ji lu	170
建筑物照明通电试运行检验批质量验收记录表	jian zhu wu zhao ming tong dian shi yun xing jian yan pi zhi liang yan shou ji lu biao	140
建筑用地钉桩通知书	jian zhu yong di ding zhuang tong zhi shu	733
建筑与结构分部工程质量竣工验收记录	jian zhu yu jie gou fen bu gong cheng zhi liang jun gong yan shou ji lu	311
建筑照明通电试验记录	jian zhu zhao ming tong dian shi yan ji lu	42
建筑中水系统及游泳池水系统安装工程检验批质量验收记录表	jian zhu zhong shui xi tong ji you yong chi shui xi tong an zhuang gong cheng jian yan pi zhi liang yan shou ji lu biao	197
建筑中水系统及游泳池系统	jian zhu zhong shui xi tong ji you yong chi xi tong	198
建筑装饰装修	jian zhu zhuang shi zhuang xiu	375
降水与排水工程检验批质量验收记录表	jiang shui yu pai shui gong cheng jian yan pi zhi liang yan shou ji lu biao	458
胶合木工程检验批质量验收记录表	jiao he mu gong cheng jian yan pi zhi liang yan shou ji lu biao	379
交桩复测报告	jiao zhuang fu ce bao gao	4
接地或接零导通状态及插座接线正确性测试记录	jie di huo jie ling dao tong zhuang tai ji cha zuo jie xian zheng que xing ce shi ji lu	153
接地装置安装检验批质量验收记录表	jie di zhuang zhi an zhuang jian yan pi zhi liang yan shou ji lu biao	139
结构实体砼强度评定表	jie gou shi ti tong qiang du ping ding biao	552
结构实体同条件养护试块试验报告	jie gou shi ti tong tiao jian yang hu shi kuai shi yan bao gao	556
洁净室洁净度检测记录	jie jing shi jie jing du jian ce ji lu	36
接入网设备分项工程质量验收记录表	jie ru wang she bei fen xiang gong cheng zhi liang yan shou ji lu biao	68
接闪器安装检验批质量验收记录表	jie shan qi an zhuang jian yan pi zhi liang yan shou ji lu biao	116
进场设备原材料构配件报验记录	jin chang she bei yuan cai liao gou pei jian bao yan ji lu	186
进场设备原材料构配件汇总表	jin chang she bei yuan cai liao gou pei jian hui zong biao	187
进场设备原材料构配件外观检查记录	jin chang she bei yuan cai liao gou pei jian wai guan jian cha ji lu	185
金属板防水层检验批质量验收记录表	jin shu ban fang shui ceng jian yan pi zhi liang yan shou ji lu biao	430
金属螺旋管合格证书出厂检验报告及进场复验报告	jin shu luo xuan guan he ge zheng shu chu chang jian yan bao gao ji jin chang fu yan bao gao	608
金属门窗安装工程检验批质量验收记录表钢门窗	jin shu men chuang an zhuang gong cheng jian yan pi zhi liang yan shou ji lu biao gang men chuang	349
金属门窗安装工程检验批质量验收记录表铝合金门窗	jin shu men chuang an zhuang gong cheng jian yan pi zhi liang yan shou ji lu biao lv he jin men chuang	348
金属门窗安装工程检验批质量验收记录表涂色镀锌钢板门窗	jin shu men chuang an zhuang gong cheng jian yan pi zhi liang yan shou ji lu biao tu se du xin gang ban men chuang	347
金属幕墙工程检验批质量验收记录表	jin shu mu qiang gong cheng jian yan pi zhi liang yan shou ji lu biao	330
静力压桩工程检验批质量验收记录表	jing li ya zhuang gong cheng jian yan pi zhi liang yan shou ji lu biao	442
九工程质量事故及事故调查处理资料	jiu gong cheng zhi liang shi gu ji shi gu diao cha chu li zi liao	473
卷材防水层检验批质量验收记录表	juan cai fang shui ceng jian yan pi zhi liang yan shou ji lu biao	432
卷材防水屋面	juan cai fang shui wu mian	310
决策立项文件	jue ce li xiang wen jian	750
绝热材料的产品质量合格证及检测报告	jue re cai liao de chan pin zhi liang he ge zheng ji jian ce bao gao	285
竣工报告	jun gong bao gao	636
竣工工程概况表	jun gong gong cheng gai kuang biao	22
竣工验收报告	jun gong yan shou bao gao	26
竣工验收备案表	jun gong yan shou bei an biao	25
竣工验收结论汇总	jun gong yan shou jie lun hui zong	65
竣工验收证明	jun gong yan shou zheng ming	27
竣工移交证书	jun gong yi jiao zheng shu	677
开工报告	kai gong bao gao	637
开工审批文件	kai gong shen pi wen jian	718
开关插座风扇安装检验批质量验收记录表	kai guan cha zuo feng shan an zhuang jian yan pi zhi liang yan shou ji lu biao	128
勘察测绘和设计文件	kan cha ce hui he she ji wen jian	736
勘察单位资质证书及相关人员资格证书	kan cha dan wei zi zhi zheng shu ji xiang guan ren yuan zi ge zheng shu	706
勘察招投标文件及勘察合同	kan cha zhao tou biao wen jian ji kan cha he tong	722
抗渗砼试块抗渗试验报告	kang shen tong shi kuai kang shen shi yan bao gao	555
可行性报告审批意见	ke xing xing bao gao shen pi yi jian	746
可行性研究报告及附件	ke xing xing yan jiu bao gao ji fu jian	747
空调系统试运转调试记录	kong tiao xi tong shi yun zhuan tiao shi ji lu	38
空调与通风系统分项工程质量验收记录表	kong tiao yu tong feng xi tong fen xiang gong cheng zhi liang yan shou ji lu biao	75
控制器日检登记表	kong zhi qi ri jian deng ji biao	109
冷冻和冷却水系统分项工程质量验收记录表	leng dong he leng que shui xi tong fen xiang gong cheng zhi liang yan shou ji lu biao	80
六施工记录	liu shi gong ji lu	517
楼层平面放线记录	lou ceng ping mian fang xian ji lu	617
漏电开关模拟试验记录	lou dian kai guan mo ni shi yan ji lu	168
楼面及屋面立管洞盛水试验	lou mian ji wu mian li guan dong sheng shui shi yan	250
炉渣垫层检验批质量验收记录表	lu zha dian ceng jian yan pi zhi liang yan shou ji lu biao	368
裸母线封闭母线插接式母线安装检验批质量验收记录表	luo mu xian feng bi mu xian cha jie shi mu xian an zhuang jian yan pi zhi liang yan shou ji lu biao	136
裸母线裸导线电缆头部件及接线端子钢制灯柱砼电秆和其它砼制品合格证	luo mu xian luo dao xian dian lan tou bu jian ji jie xian duan zi gang zhi deng zhu tong dian gan he qi ta tong zhi pin he ge zheng	175
锚杆及土钉墙支护工程检验批质量验收记录表	mao gan ji tu ding qiang zhi hu gong cheng jian yan pi zhi liang yan shou ji lu biao	455
锚喷支护检验批质量验收记录表	mao pen zhi hu jian yan pi zhi liang yan shou ji lu biao	427
煤气管道工程隐蔽记录	mei qi guan dao gong cheng yin bi ji lu	257
美术涂饰工程检验批质量验收记录表	mei shu tu shi gong cheng jian yan pi zhi liang yan shou ji lu biao	325
门窗	men chuang	352
门窗玻璃安装工程检验批质量验收记录表	men chuang bo li an zhuang gong cheng jian yan pi zhi liang yan shou ji lu biao	344
门窗材料产品合格证书性能检测报告	men chuang cai liao chan pin he ge zheng shu xing neng jian ce bao gao	580
门窗套制作与安装工程检验批质量验收记录表	men chuang tao zhi zuo yu an zhuang gong cheng jian yan pi zhi liang yan shou ji lu biao	318
门窗隐蔽部位的防腐填嵌处理隐蔽验收记录	men chuang yin bi bu wei de fang fu tian qian chu li yin bi yan shou ji lu	524
门窗预埋件和锚固件的隐蔽验收记录	men chuang yu mai jian he mao gu jian de yin bi yan shou ji lu	525
密封胶对石材污染性复验报告	mi feng jiao dui shi cai wu ran xing fu yan bao gao	569
明龙骨吊顶工程检验批质量验收记录表	ming long gu diao ding gong cheng jian yan pi zhi liang yan shou ji lu biao	341
模板安装工程检验批质量验收记录表	mo ban an zhuang gong cheng jian yan pi zhi liang yan shou ji lu biao	418
模板拆除工程检验批质量验收记录表	mo ban chai chu gong cheng jian yan pi zhi liang yan shou ji lu biao	416
抹灰	mo hui	356
抹灰工程饰面砖工程用水泥复验报告	mo hui gong cheng shi mian zhuan gong cheng yong shui ni fu yan bao gao	581
抹灰工程隐蔽验收记录	mo hui gong cheng yin bi yan shou ji lu	526
木结构	mu jie gou	381
木结构防腐防虫防火工程检验批质量验收记录表	mu jie gou fang fu fang chong fang huo gong cheng jian yan pi zhi liang yan shou ji lu biao	377
木结构工程各规范强制性条检查记录表	mu jie gou gong cheng ge gui fan qiang zhi xing tiao jian cha ji lu biao	298
木结构施工记录	mu jie gou shi gong ji lu	491
木门窗安装工程检验批质量验收记录表	mu men chuang an zhuang gong cheng jian yan pi zhi liang yan shou ji lu biao	350
木门窗制作工程检验批质量验收记录表	mu men chuang zhi zuo gong cheng jian yan pi zhi liang yan shou ji lu biao	351
幕墙	mu qiang	332
幕墙防雷防火隐蔽验收记录	mu qiang fang lei fang huo yin bi yan shou ji lu	518
幕墙工程所用各种材料五金配件构件及组件的产品合格证书性能检测报告	mu qiang gong cheng suo yong ge zhong cai liao wu jin pei jian gou jian ji zu jian de chan pin he ge zheng shu xing neng jian ce bao gao	574
幕墙及外窗气密性水密性耐风压检测报告	mu qiang ji wai chuang qi mi xing shui mi xing nai feng ya jian ce bao gao	48
幕墙连接节点变形缝隐蔽验收记录	mu qiang lian jie jie dian bian xing feng yin bi yan shou ji lu	519
幕墙注胶检查记录	mu qiang zhu jiao jian cha ji lu	490
木屋盖工程检验批质量验收记录表	mu wu gai gong cheng jian yan pi zhi liang yan shou ji lu biao	380
粘土砖出厂合格证书复试报告汇总表	nian tu zhuan chu chang he ge zheng shu fu shi bao gao hui zong biao	599
排水管通球试验	pai shui guan tong qiu shi yan	44
排桩墙支护工程检验批质量验收记录表重复使用钢板桩	pai zhuang qiang zhi hu gong cheng jian yan pi zhi liang yan shou ji lu biao chong fu shi yong gang ban zhuang	460
排桩墙支护工程检验批质量验收记录表混凝土板桩	pai zhuang qiang zhi hu gong cheng jian yan pi zhi liang yan shou ji lu biao hun ning tu ban zhuang	459
配筋砌体工程检验批质量验收记录表	pei jin qi ti gong cheng jian yan pi zhi liang yan shou ji lu biao	390
配线敷设施工隐蔽验收记录	pei xian fu she shi gong yin bi yan shou ji lu	155
普通灯具安装检验批质量验收记录表	pu tong deng ju an zhuang jian yan pi zhi liang yan shou ji lu biao	123
普通紧固件连接工程检验批质量验收记录表	pu tong jin gu jian lian jie gong cheng jian yan pi zhi liang yan shou ji lu biao	406
七分项分部工程质量验收记录	qi fen xiang fen bu gong cheng zhi liang yan shou ji lu	290
其他钢材合格证书复试报告	qi ta gang cai he ge zheng shu fu shi bao gao	606
其他墙体材料合格证及复试报告	qi ta qiang ti cai liao he ge zheng ji fu shi bao gao	596
其他外加剂合格证进场试验报告	qi ta wai jia ji he ge zheng jin chang shi yan bao gao	590
其他文件	qi ta wen jian	696
砌体结构	qi ti jie gou	395
砌体结构工程各规范强制性条检查记录表	qi ti jie gou gong cheng ge gui fan qiang zhi xing tiao jian cha ji lu biao	299
七预制构件预拌砼合格证	qi yu zhi gou jian yu ban tong he ge zheng	485
砌筑砂浆试块强度评定表	qi zhu sha jiang shi kuai qiang du ping ding biao	545
洽商记录	qia shang ji lu	626
强度严密性试验记录	qiang du yan mi xing shi yan ji lu	271
强夯地基工程检验批质量验收记录表	qiang hang di ji gong cheng jian yan pi zhi liang yan shou ji lu biao	446
强制措施条文检测记录	qiang zhi cuo shi tiao wen jian ce ji lu	62
清水砌体勾缝工程检验批质量验收记录表	qing shui qi ti gou feng gong cheng jian yan pi zhi liang yan shou ji lu biao	353
清洗试验记录	qing xi shi yan ji lu	2
轻型木结构规格材钉连接工程检验批质量验收记录表	qing xing mu jie gou gui ge cai ding lian jie gong cheng jian yan pi zhi liang yan shou ji lu biao	378
轻质隔墙	qing zhi ge qiang	340
轻质隔墙隐蔽验收记录	qing zhi ge qiang yin bi yan shou ji lu	522
燃气管道检漏记录	ran qi guan dao jian lou ji lu	263
热水供应系统辅助设备安装工程检验批质量验收记录表	re shui gong ying xi tong fu zhu she bei an zhuang gong cheng jian yan pi zhi liang yan shou ji lu biao	215
热源和热交换系统分项工程质量验收记录表	re yuan he re jiao huan xi tong fen xiang gong cheng zhi liang yan shou ji lu biao	79
人工挖孔灌注桩施工验收记录	ren gong wa kong guan zhu zhuang shi gong yan shou ji lu	510
人造木板合格证甲醛含量复验报告	ren zao mu ban he ge zheng jia quan han liang fu yan bao gao	585
溶剂型涂料涂饰工程检验批质量验收记录表	rong ji xing tu liao tu shi gong cheng jian yan pi zhi liang yan shou ji lu biao	326
入侵报警系统分项工程质量验收记录表	ru qin bao jing xi tong fen xiang gong cheng zhi liang yan shou ji lu biao	89
软包工程检验批质量验收记录表	ruan bao gong cheng jian yan pi zhi liang yan shou ji lu biao	322
软包面料内衬产品合格证性能检测报告	ruan bao mian liao nei chen chan pin he ge zheng xing neng jian ce bao gao	576
三管道设备强度试验严密性试记录	san guan dao she bei qiang du shi yan yan mi xing shi ji lu	293
三管道设备强度试验严密性试验记录	san guan dao she bei qiang du shi yan yan mi xing shi yan ji lu	273
三合土垫层检验批质量验收记录表	san he tu dian ceng jian yan pi zhi liang yan shou ji lu biao	369
三设备调试记录	san she bei tiao shi ji lu	174
三原材料出厂合格证书及进场检验报告	san yuan cai liao chu chang he ge zheng shu ji jin chang jian yan bao gao	614
砂出厂合格证及试验报告	sha chu chang he ge zheng ji shi yan bao gao	563
砂垫层和砂石垫层检验批质量验收记录表	sha dian ceng he sha shi dian ceng jian yan pi zhi liang yan shou ji lu biao	371
砂和砂石地基检验批质量验收记录表	sha he sha shi di ji jian yan pi zhi liang yan shou ji lu biao	449
砂浆抗压强度试验报告	sha jiang kang ya qiang du shi yan bao gao	548
砂浆配合比通知单	sha jiang pei he bi tong zhi dan	550
砂浆试块见证取样记录表	sha jiang shi kuai jian zheng qu yang ji lu biao	549
砂浆试块试验试压报告	sha jiang shi kuai shi yan shi ya bao gao	551
砂浆外加剂合格证进场试验报告	sha jiang wai jia ji he ge zheng jin chang shi yan bao gao	591
砂石出厂合格证复试报告汇总表	sha shi chu chang he ge zheng fu shi bao gao hui zong biao	565
砂石出厂合格证及试验报告汇总表	sha shi chu chang he ge zheng ji shi yan bao gao hui zong biao	564
砂桩地基工程检验批质量验收记录表	sha zhuang di ji gong cheng jian yan pi zhi liang yan shou ji lu biao	444
商务文件	shang wu wen jian	702
设备材料报验单	she bei cai liao bao yan dan	275
设备材料进场检验表	she bei cai liao jin chang jian yan biao	55
设备单机试运转记录	she bei dan ji shi yun zhuan ji lu	245
设备基础交接记录	she bei ji chu jiao jie ji lu	247
设备开箱检验记录	she bei kai xiang jian yan ji lu	274
设计变更	she ji bian geng	623
设计单位项目组织机构及负责人	she ji dan wei xiang mu zu zhi ji gou ji fu ze ren	708
设计单位资质证书及相关人员资格证书	she ji dan wei zi zhi zheng shu ji xiang guan ren yuan zi ge zheng shu	705
设计计算书	she ji ji suan shu	726
设计交底记录	she ji jiao di ji lu	624
设计招投标文件及设计合同	she ji zhao tou biao wen jian ji she ji he tong	721
审定设计方案通知书及	shen ding she ji fang an tong zhi shu ji	730
渗排水盲沟排水检验批质量验收记录表	shen pai shui mang gou pai shui jian yan pi zhi liang yan shou ji lu biao	423
生活给水系统水质卫生检验报告	sheng huo gei shui xi tong shui zhi wei sheng jian yan bao gao	252
石材幕墙工程检验批质量验收记录表	shi cai mu qiang gong cheng jian yan pi zhi liang yan shou ji lu biao	329
石出厂合格证及试验报告	shi chu chang he ge zheng ji shi yan bao gao	562
十二工程质量控制的强制条文	shi er gong cheng zhi liang kong zhi de qiang zhi tiao wen	303
施工单位项目组织机构及负责人	shi gong dan wei xiang mu zu zhi ji gou ji fu ze ren	709
施工单位资质证书及相关人员资格证书	shi gong dan wei zi zhi zheng shu ji xiang guan ren yuan zi ge zheng shu	704
施工阶段监理类常用表格	shi gong jie duan jian li lei chang yong biao ge	657
施工日志	shi gong ri zhi	515
施工试验记录	shi gong shi yan ji lu	516
施工图设计及说明	shi gong tu she ji ji shuo ming	727
施工图设计文件审查通知书及施工图审查报告	shi gong tu she ji wen jian shen cha tong zhi shu ji shi gong tu shen cha bao gao	724
施工图预算	shi gong tu yu suan	698
施工现场质量管理检查记录	shi gong xian chang zhi liang guan li jian cha ji lu	639
施工预算	shi gong yu suan	699
施工招标文件中标通知书	shi gong zhao biao wen jian zhong biao tong zhi shu	635
施工招投标文件及施工合同	shi gong zhao tou biao wen jian ji shi gong he tong	720
施工资料	shi gong zi liao	643
施工组织设计报审表	shi gong zu zhi she ji bao shen biao	674
施工组织设计施工方案审批表	shi gong zu zhi she ji shi gong fang an shen pi biao	638
饰面板	shi mian ban	335
饰面板安装工程检验批质量验收记录表	shi mian ban an zhuang gong cheng jian yan pi zhi liang yan shou ji lu biao	334
饰面板工程隐蔽验收记录	shi mian ban gong cheng yin bi yan shou ji lu	521
饰面砖石材幕墙后置埋件现场拉拔试验报告	shi mian zhuan shi cai mu qiang hou zhi mai jian xian chang la ba shi yan bao gao	571
饰面砖粘贴工程检验批质量验收记录表	shi mian zhuan zhan tie gong cheng jian yan pi zhi liang yan shou ji lu biao	333
室内采暖辅助设备及散热器及金属辐射板安装工程检验批质量验收记录表	shi nei cai nuan fu zhu she bei ji san re qi ji jin shu fu she ban an zhuang gong cheng jian yan pi zhi liang yan shou ji lu biao	209
室内采暖管道及配件安装工程检验批质量验收记录表	shi nei cai nuan guan dao ji pei jian an zhuang gong cheng jian yan pi zhi liang yan shou ji lu biao	210
室内采暖系统	shi nei cai nuan xi tong	211
室内给水系统	shi nei gei shui xi tong	224
室内给水管道及配件安装工程检验批质量验收记录表	shi nei ji shui guan dao ji pei jian an zhuang gong cheng jian yan pi zhi liang yan shou ji lu biao	223
室内排水管道及配件安装工程检验批质量验收记录表	shi nei pai shui guan dao ji pei jian an zhuang gong cheng jian yan pi zhi liang yan shou ji lu biao	219
室内排水管道通球试验记录	shi nei pai shui guan dao tong qiu shi yan ji lu	236
室内排水系统	shi nei pai shui xi tong	220
室内热水供应系统	shi nei re shui gong ying xi tong	217
室内热水管道及配件安装工程检验批质量验收记录表	shi nei re shui guan dao ji pei jian an zhuang gong cheng jian yan pi zhi liang yan shou ji lu biao	216
室内外给排水工程隐蔽验收记录	shi nei wai gei pai shui gong cheng yin bi yan shou ji lu	258
室内外饰面砖石材合格证	shi nei wai shi mian zhuan shi cai he ge zheng	583
室内消火栓系统安装工程检验批质量验收记录表	shi nei xiao huo shuan xi tong an zhuang gong cheng jian yan pi zhi liang yan shou ji lu biao	222
室内用花岗岩放射性复验报告	shi nei yong hua gang yan fang she xing fu yan bao gao	582
视频安防监控系统分项工程质量验收记录表	shi pin an fang jian kong xi tong fen xiang gong cheng zhi liang yan shou ji lu biao	88
石砌体工程检验批质量验收记录表	shi qi ti gong cheng jian yan pi zhi liang yan shou ji lu biao	392
室外电气	shi wai dian qi	148
室外电气变压器箱式变电所安装检验批质量验收记录表	shi wai dian qi bian ya qi xiang shi bian dian suo an zhuang jian yan pi zhi liang yan shou ji lu biao	146
室外电气架空线路及杆上电气设备安装检验批质量验收记录表	shi wai dian qi jia kong xian lu ji gan shang dian qi she bei an zhuang jian yan pi zhi liang yan shou ji lu biao	147
室外供热管道及配件安装工程检验批质量验收记录表	shi wai gong re guan dao ji pei jian an zhuang gong cheng jian yan pi zhi liang yan shou ji lu biao	199
室外供热管网	shi wai gong re guan wang	200
室外给水管道安装工程检验批质量验收记录表	shi wai ji shui guan dao an zhuang gong cheng jian yan pi zhi liang yan shou ji lu biao	206
室外给水管网	shi wai ji shui guan wang	207
室外排水管道安装工程检验批质量验收记录表	shi wai pai shui guan dao an zhuang gong cheng jian yan pi zhi liang yan shou ji lu biao	202
室外排水管沟及井池工程检验批质量验收记录表	shi wai pai shui guan gou ji jing chi gong cheng jian yan pi zhi liang yan shou ji lu biao	201
室外排水管网	shi wai pai shui guan wang	203
十新材料新工艺施工记录	shi xin cai liao xin gong yi shi gong ji lu	469
试验单位资质等级计量认证报审表	shi yan dan wei zi zhi deng ji ji liang ren zheng bao shen biao	631
十一分部分项工程质量验收记录	shi yi fen bu fen xiang gong cheng zhi liang yan shou ji lu	466
首桩隐蔽工程验收记录表	shou zhuang yin bi gong cheng yan shou ji lu biao	5
数据通信接口分项工程质量验收记录表	shu ju tong xin jie kou fen xiang gong cheng zhi liang yan shou ji lu biao	82
疏散照明备用照明安全照明电源转换时间测试记录	shu san zhao ming bei yong zhao ming an quan zhao ming dian yuan zhuan huan shi jian ce shi ji lu	160
水泵安装记录	shui beng an zhuang ji lu	227
水泵锅炉及主要器具安全使用说明书及合格证	shui beng guo lu ji zhu yao qi ju an quan shi yong shuo ming shu ji he ge zheng	277
水泵试车记录	shui beng shi che ji lu	228
水磨石面层检验批质量验收记录表	shui mo shi mian ceng jian yan pi zhi liang yan shou ji lu biao	362
水泥出厂合格证复试报告汇总表	shui ni chu chang he ge zheng fu shi bao gao hui zong biao	605
水泥出厂合格证及进场复试报告	shui ni chu chang he ge zheng ji jin chang fu shi bao gao	603
水泥出厂合格证书复试报告汇总表	shui ni chu chang he ge zheng shu fu shi bao gao hui zong biao	604
水泥钢屑检验批质量验收记录表	shui ni gang xie jian yan pi zhi liang yan shou ji lu biao	361
水泥混凝土垫层检验批质量验收记录表	shui ni hun ning tu dian ceng jian yan pi zhi liang yan shou ji lu biao	367
水泥混凝土面层检验批质量验收记录表	shui ni hun ning tu mian ceng jian yan pi zhi liang yan shou ji lu biao	363
水泥砂浆防水层检验批质量验收记录表	shui ni sha jiang fang shui ceng jian yan pi zhi liang yan shou ji lu biao	433
水文地质勘察报告自然条件地震调查	shui wen di zhi kan cha bao gao zi ran tiao jian di zhen diao cha	734
水性涂料涂饰工程检验批质量验收记录表	shui xing tu liao tu shi gong cheng jian yan pi zhi liang yan shou ji lu biao	327
四接地绝缘电阻测试记录	si jie di jue yuan dian zu ce shi ji lu	164
四施工试验报告及见证检测报告	si shi gong shi yan bao gao ji jian zheng jian ce bao gao	561
四隐蔽验收记录	si yin bi yan shou ji lu	292
塑料板防水层检验批质量验收记录表	su liao ban fang shui ceng jian yan pi zhi liang yan shou ji lu biao	429
塑料管见证取样送检报告	su liao guan jian zheng qu yang song jian bao gao	276
塑料门窗安装工程检验批质量验收记录表	su liao men chuang an zhuang gong cheng jian yan pi zhi liang yan shou ji lu biao	346
塑料排水管伸缩器安装预留伸缩量记录	su liao pai shui guan shen suo qi an zhuang yu liu shen suo liang ji lu	248
隧道坑道排水检验批质量验收记录表	sui dao keng dao pai shui jian yan pi zhi liang yan shou ji lu biao	422
碎石垫层和碎砖垫层检验批质量验收记录表	sui shi dian ceng he sui zhuan dian ceng jian yan pi zhi liang yan shou ji lu biao	370
特种门安装工程检验批质量验收记录表	te zhong men an zhuang gong cheng jian yan pi zhi liang yan shou ji lu biao	345
特种门及其附件的生产许可文件合格证书	te zhong men ji qi fu jian de sheng chan xu ke wen jian he ge zheng shu	579
特种砂浆试块试验报告	te zhong sha jiang shi kuai shi yan bao gao	546
特种砼试块试验报告	te zhong tong shi kuai shi yan bao gao	554
填充层检验批质量验收记录表	tian chong ceng jian yan pi zhi liang yan shou ji lu biao	364
填充墙砌体工程检验批质量验收记录表	tian chong qiang qi ti gong cheng jian yan pi zhi liang yan shou ji lu biao	391
调试报告	tiao shi bao gao	106
停车场库管理系统分项工程质量验收记录表	ting che chang ku guan li xi tong fen xiang gong cheng zhi liang yan shou ji lu biao	92
通风烟道垃圾道检查记录	tong feng yan dao la ji dao jian cha ji lu	496
砼工程施工记录	tong gong cheng shi gong ji lu	508
砼构件合格证	tong gou jian he ge zheng	483
砼构件结构性能检验报告	tong gou jian jie gou xing neng jian yan bao gao	482
砼结构试块养护测温记录	tong jie gou shi kuai yang hu ce wen ji lu	6
砼强度评定表	tong qiang du ping ding biao	553
通球试验记录	tong qiu shi yan ji lu	268
砼试块见证取样记录	tong shi kuai jian zheng qu yang ji lu	558
砼试块试验报告	tong shi kuai shi yan bao gao	557
砼试块试验试压报告	tong shi kuai shi yan shi ya bao gao	560
通水试验记录	tong shui shi yan ji lu	270
砼外加剂产品合格证出厂检测报告和复试报告	tong wai jia ji chan pin he ge zheng chu chang jian ce bao gao he fu shi bao gao	593
砼小型砌块合格证及复试报告	tong xiao xing qi kuai he ge zheng ji fu shi bao gao	597
统一标准强文检查记录表	tong yi biao zhun qiang wen jian cha ji lu biao	190
统一标准强制性条检查记录表	tong yi biao zhun qiang zhi xing tiao jian cha ji lu biao	115
投资许可证审计证明缴纳绿化建设费等证明	tou zi xu ke zheng shen ji zheng ming jiao na lv hua jian she fei deng zheng ming	713
土方回填工程检验批质量验收记录表	tu fang hui tian gong cheng jian yan pi zhi liang yan shou ji lu biao	462
土方开挖工程检验批质量验收记录表	tu fang kai wa gong cheng jian yan pi zhi liang yan shou ji lu biao	463
土工合成材料地基工程检验批质量验收记录表	tu gong he cheng cai liao di ji gong cheng jian yan pi zhi liang yan shou ji lu biao	448
涂料产品合格证书性能检测报告	tu liao chan pin he ge zheng shu xing neng jian ce bao gao	578
涂料防水层检验批质量验收记录表	tu liao fang shui ceng jian yan pi zhi liang yan shou ji lu biao	431
涂膜防水屋面	tu mo fang shui wu mian	307
土壤试验报告	tu rang shi yan bao gao	537
土壤试验记录	tu rang shi yan ji lu	539
土壤试验记录汇总表	tu rang shi yan ji lu hui zong biao	538
涂饰	tu shi	328
图纸会审记录	tu zhi hui shen ji lu	627
挖孔扩底灌注桩隐蔽工程验收表	wa kong kuo di guan zhu zhuang yin bi gong cheng yan shou biao	18
瓦屋面	wa wu mian	305
外加剂产品合格证复试报告汇总表	wai jia ji chan pin he ge zheng fu shi bao gao hui zong biao	595
外加剂产品合格证书复试报告汇总表	wai jia ji chan pin he ge zheng shu fu shi bao gao hui zong biao	594
外墙饰面砖墙板件粘结强度检测报告	wai qiang shi mian zhuan qiang ban jian nian jie qiang du jian ce bao gao	570
网架和索膜结构	wang jia he suo mo jie gou	376
网络安全系统检测分项工程质量验收记录表	wang luo an quan xi tong jian ce fen xiang gong cheng zhi liang yan shou ji lu biao	74
网络施工记录	wang luo shi gong ji lu	492
卫生洁具环保检测报告	wei sheng jie ju huan bao jian ce bao gao	282
卫生器具安装	wei sheng qi ju an zhuang	214
卫生器具及给水配件安装工程检验批质量验收记录表	wei sheng qi ju ji ji shui pei jian an zhuang gong cheng jian yan pi zhi liang yan shou ji lu biao	213
卫生器具满水试验表	wei sheng qi ju man shui shi yan biao	46
卫生器具排水管道安装工程检验批质量验收记录表	wei sheng qi ju pai shui guan dao an zhuang gong cheng jian yan pi zhi liang yan shou ji lu biao	212
卫星数字电视系统分项工程质量验收记录表	wei xing shu zi dian shi xi tong fen xiang gong cheng zhi liang yan shou ji lu biao	69
温湿度记录表	wen shi du ji lu biao	11
屋面保温层检验批质量验收记录表	wu mian bao wen ceng jian yan pi zhi liang yan shou ji lu biao	309
屋面防水构造隐蔽验收记录	wu mian fang shui gou zao yin bi yan shou ji lu	527
屋面淋水试验记录	wu mian lin shui shi yan ji lu	53
屋面找平层检验批质量验收记录表	wu mian zhao ping ceng jian yan pi zhi liang yan shou ji lu biao	308
无损探伤报告	wu sun tan shang bao gao	251
五系统清洗灌水通水通球试验记录	wu xi tong qing xi guan shui tong shui tong qiu shi yan ji lu	291
五隐蔽验收记录	wu yin bi yan shou ji lu	535
无支护土方	wu zhi hu tu fang	464
细部	xi bu	321
细部构造检验批质量验收记录表	xi bu gou zao jian yan pi zhi liang yan shou ji lu biao	428
系统电源及接地检测报告	xi tong dian yuan ji jie di jian ce bao gao	33
系统分部工程检测汇总表	xi tong fen bu gong cheng jian ce hui zong biao	63
系统集成可维护性和安全性分项工程质量验收记录表	xi tong ji cheng ke wei hu xing he an quan xing fen xiang gong cheng zhi liang yan shou ji lu biao	100
系统集成网络连接分项工程质量验收记录表	xi tong ji cheng wang luo lian jie fen xiang gong cheng zhi liang yan shou ji lu biao	96
系统集成整体协调分项工程质量验收记录表	xi tong ji cheng zheng ti xie tiao fen xiang gong cheng zhi liang yan shou ji lu biao	98
系统集成综合管理及冗余功能分项工程质量验收记录表	xi tong ji cheng zong he guan li ji rong yu gong neng fen xiang gong cheng zhi liang yan shou ji lu biao	99
系统竣工表	xi tong jun gong biao	107
系统清洗灌水通水通球试验记录	xi tong qing xi guan shui tong shui tong qiu shi yan ji lu	256
系统实时性可维护性可靠性分项工程质量验收记录表	xi tong shi shi xing ke wei hu xing ke kao xing fen xiang gong cheng zhi liang yan shou ji lu biao	84
系统试运行记录	xi tong shi yun xing ji lu	59
系统数据集成分项工程质量验收记录表	xi tong shu ju ji cheng fen xiang gong cheng zhi liang yan shou ji lu biao	97
系统运行日登记表	xi tong yun xing ri deng ji biao	108
现场设备安装及检测分项工程质量验收记录	xian chang she bei an zhuang ji jian ce fen xiang gong cheng zhi liang yan shou ji lu	85
现浇结构外观及尺寸允许偏差检验批质量验收记录表	xian jiao jie gou wai guan ji chi cun yun xu pian cha jian yan pi zhi liang yan shou ji lu biao	411
线路插座开关接地检验记录	xian lu cha zuo kai guan jie di jian yan ji lu	39
线路设备绝缘电阻测试记录	xian lu she bei jue yuan dian zu ce shi ji lu	163
项目建设书审批意见及前期工作通知书	xiang mu jian she shu shen pi yi jian ji qian qi gong zuo tong zhi shu	748
项目建议书	xiang mu jian yi shu	749
消防燃气管道压力试验记录	xiao fang ran qi guan dao ya li shi yan ji lu	45
消防设计及说明	xiao fang she ji ji shuo ming	725
消防水泵结合器及消火栓安装工程检验批质量验收记录表	xiao fang shui beng jie he qi ji xiao huo shuan an zhuang gong cheng jian yan pi zhi liang yan shou ji lu biao	205
消火栓试射记录	xiao huo shuan shi she ji lu	266
消火栓系统试射试验记录	xiao huo shuan xi tong shi she shi yan ji lu	232
新技术新工艺新技术新设备应用申报审批表	xin ji shu xin gong yi xin ji shu xin she bei ying yong shen bao shen pi biao	467
新技术新设备新材料新工艺施工记录	xin ji shu xin she bei xin cai liao xin gong yi shi gong ji lu	468
型钢和电焊条合格证和材料质证明书	xing gang he dian han tiao he ge zheng he cai liao zhi zheng ming shu	178
选址申请及选址规划意见通知书	xuan zhi shen qing ji xuan zhi gui hua yi jian tong zhi shu	741
巡更管理系统分项工程质量验收记录表	xun geng guan li xi tong fen xiang gong cheng zhi liang yan shou ji lu biao	91
压型金属板工程检验批质量验收记录表	ya xing jin shu ban gong cheng jian yan pi zhi liang yan shou ji lu biao	382
压桩施工记录	ya zhuang shi gong ji lu	9
验线通知单	yan xian tong zhi dan	732
一般抹灰工程检验批质量验收记录表	yi ban mo hui gong cheng jian yan pi zhi liang yan shou ji lu biao	355
仪表计量检定证书计量站提供	yi biao ji liang jian ding zheng shu ji liang zhan ti gong	280
一图纸会审设计变更洽商记录	yi tu zhi hui shen she ji bian geng qia shang ji lu	628
隐蔽工程检查记录	yin bi gong cheng jian cha ji lu	534
隐蔽工程随工检查验收表	yin bi gong cheng sui gong jian cha yan shou biao	56
隐蔽管注水试验记录	yin bi guan zhu shui shi yan ji lu	238
应用软件系统检测分项工程质量验收记录表	ying yong ruan jian xi tong jian ce fen xiang gong cheng zhi liang yan shou ji lu biao	73
有防水要求的地面淋水蓄水试验记录	you fang shui yao qiu de di mian lin shui xu shui shi yan ji lu	51
有关单位批准文件或协议	you guan dan wei pi zhun wen jian huo xie yi	729
有粘结预应力结构灌浆记录	you nian jie yu ying li jie gou guan jiang ji lu	494
有线电视系统分项工程质量验收记录表	you xian dian shi xi tong fen xiang gong cheng zhi liang yan shou ji lu biao	70
有支护土方	you zhi hu tu fang	461
预拌混凝土运输单	yu ban hun ning tu yun shu dan	506
预检记录	yu jian ji lu	488
预搅拌砼合格证及试块强度报告	yu jiao ban tong he ge zheng ji shi kuai qiang du bao gao	481
雨水管道及配件安装工程检验批质量验收记录表	yu shui guan dao ji pei jian an zhuang gong cheng jian yan pi zhi liang yan shou ji lu biao	218
预应力钢筋合格证书进场检验复试报告	yu ying li gang jin he ge zheng shu jin chang jian yan fu shi bao gao	607
预应力钢筋隐蔽验收记录	yu ying li gang jin yin bi yan shou ji lu	531
预应力钢丝墩头强度试验报告	yu ying li gang si dun tou qiang du shi yan bao gao	540
预应力灌浆用水泥试块试验报告	yu ying li guan jiang yong shui ni shi kuai shi yan bao gao	547
预应力管桩工程检验批质量验收记录表	yu ying li guan zhuang gong cheng jian yan pi zhi liang yan shou ji lu biao	441
预应力筋张拉记录	yu ying li jin zhang la ji lu	495
预应力孔道灌浆水泥复试报告	yu ying li kong dao guan jiang shui ni fu shi bao gao	602
预应力孔道灌浆用外加剂产品合格证进场复试报告	yu ying li kong dao guan jiang yong wai jia ji chan pin he ge zheng jin chang fu shi bao gao	592
预应力锚具夹具和连接器合格证出厂检验报告及静荷载锚固性能复试报告	yu ying li mao ju jia ju he lian jie qi he ge zheng chu chang jian yan bao gao ji jing he zai mao gu xing neng fu shi bao gao	609
预应力原材料检验批质量验收记录表	yu ying li yuan cai liao jian yan pi zhi liang yan shou ji lu biao	400
预应力张拉放张灌浆及封锚检验批质量验收记录表	yu ying li zhang la fang zhang guan jiang ji feng mao jian yan pi zhi liang yan shou ji lu biao	398
预应力制作与安装检验批质量验收记录表	yu ying li zhi zuo yu an zhuang jian yan pi zhi liang yan shou ji lu biao	399
预制构件检验批质量验收记录表	yu zhi gou jian jian yan pi zhi liang yan shou ji lu biao	397
预制构件模板工程检验批质量验收记录表	yu zhi gou jian mo ban gong cheng jian yan pi zhi liang yan shou ji lu biao	417
预制构件预搅拌混凝土合格证汇总表	yu zhi gou jian yu jiao ban hun ning tu he ge zheng hui zong biao	484
预注浆后注浆检验批质量验收记录表	yu zhu jiang hou zhu jiang jian yan pi zhi liang yan shou ji lu biao	421
照明灯具开关插座风扇及附件出厂合格证及技术文件	zhao ming deng ju kai guan cha zuo feng shan ji fu jian chu chang he ge zheng ji ji shu wen jian	181
找平层检验批质量验收记录表	zhao ping ceng jian yan pi zhi liang yan shou ji lu biao	366
振冲地基工程检验批质量验收记录表	zhen chong di ji gong cheng jian yan pi zhi liang yan shou ji lu biao	445
蒸压灰砂砖粉煤灰砖合格证及复试报告	zheng ya hui sha zhuan fen mei hui zhuan he ge zheng ji fu shi bao gao	598
制冷机组调试记录	zhi leng ji zu tiao shi ji lu	35
质量检测见证取样送检记录	zhi liang jian ce jian zheng qu yang song jian ji lu	15
质量评价意见及报告	zhi liang ping jia yi jian ji bao gao	683
质量事故及处理资料	zhi liang shi gu ji chu li zi liao	682
质量问题处理记录	zhi liang wen ti chu li ji lu	8
智能建筑工程分项工程质量检测记录表	zhi neng jian zhu gong cheng fen xiang gong cheng zhi liang jian ce ji lu biao	60
智能住宅小区智能化分项工程质量验收记录表	zhi neng zhu zhai xiao qu zhi neng hua fen xiang gong cheng zhi liang yan shou ji lu biao	105
中央管理工作站及操作分站分项工程质量验收记录表	zhong yang guan li gong zuo zhan ji cao zuo fen zhan fen xiang gong cheng zhi liang yan shou ji lu biao	83
主体结构	zhu ti jie gou	402
主要材料设备等的产品质量合格证及检测报告	zhu yao cai liao she bei deng de chan pin zhi liang he ge zheng ji jian ce bao gao	286
主要器具和设备安全使用说明书	zhu yao qi ju he she bei an quan shi yong shuo ming shu	278
主要专业工种人员登记一览表	zhu yao zhuan ye gong zhong ren yuan deng ji yi lan biao	7
住宅小区智能化分项工程质量验收记录表	zhu zhai xiao qu zhi neng hua fen xiang gong cheng zhi liang yan shou ji lu biao	104
专家建议文件	zhuan jia jian yi wen jian	744
砖面层检验批质量验收记录表	zhuan mian ceng jian yan pi zhi liang yan shou ji lu biao	358
砖砌块出厂合格证复试报告汇总表	zhuan qi kuai chu chang he ge zheng fu shi bao gao hui zong biao	601
砖砌块出厂合格证书复试报告汇总表	zhuan qi kuai chu chang he ge zheng shu fu shi bao gao hui zong biao	600
砖砌体混水工程检验批质量验收记录表	zhuan qi ti hun shui gong cheng jian yan pi zhi liang yan shou ji lu biao	394
专用灯具安装检验批质量验收记录表	zhuan yong deng ju an zhuang jian yan pi zhi liang yan shou ji lu biao	122
桩地基施工记录	zhuang di ji shi gong ji lu	514
桩基	zhuang ji	443
桩基地基处理报告	zhuang ji di ji chu li bao gao	475
桩基工程隐蔽验收记录	zhuang ji gong cheng yin bi yan shou ji lu	533
桩基检测报告	zhuang ji jian ce bao gao	476
装配式结构施工检验批质量验收记录表	zhuang pei shi jie gou shi gong jian yan pi zhi liang yan shou ji lu biao	396
装饰材料合格证复试报告汇总表	zhuang shi cai liao he ge zheng fu shi bao gao hui zong biao	589
装饰材料合格证书复试报告汇总表	zhuang shi cai liao he ge zheng shu fu shi bao gao hui zong biao	588
装饰抹灰工程检验批质量验收记录表	zhuang shi mo hui gong cheng jian yan pi zhi liang yan shou ji lu biao	354
装饰装修工程各规范强制性条检查记录表	zhuang shi zhuang xiu gong cheng ge gui fan qiang zhi xing tiao jian cha ji lu biao	296
自检互检记录单	zi jian hu jian ji lu dan	489
资料审查	zi liao shen cha	64
子系统检测记录	zi xi tong jian ce ji lu	61
综合布线系统安装分项工程质量验收记录表	zong he bu xian xi tong an zhuang fen xiang gong cheng zhi liang yan shou ji lu biao	94
综合布线系统性能检测分项工程质量验收记录表	zong he bu xian xi tong xing neng jian ce fen xiang gong cheng zhi liang yan shou ji lu biao	95
综合防范功能分项工程质量验收记录表	zong he fang fan gong neng fen xiang gong cheng zhi liang yan shou ji lu biao	87
