# 文件名：注册安全工程师专用词库补充.scel
# 词库名：注册安全工程师专用词库补充
# 词库分类：社科类
# 词库描述：
# 词条样例：中华人民共和国国务院 从业人员 权利和义务 调查处理 促进经济发展
# 词条数量：1534

安监部门	an jian bu men	401
安监部门和负有安监职责的有关部门	an jian bu men he fu you an jian zhi ze de you guan bu men	137
安监部门和负有安监职责的有关部门接到事故报告后	an jian bu men he fu you an jian zhi ze de you guan bu men jie dao shi gu bao gao hou	420
安监部门和负有安监职责的有关部门应当建立值班制度	an jian bu men he fu you an jian zhi ze de you guan bu men ying dang jian li zhi ban zhi du	337
安监部门和负有安监职责的有关部门逐级上报事故情况	an jian bu men he fu you an jian zhi ze de you guan bu men zhu ji shang bao shi gu qing kuang	398
安监职责	an jian zhi ze	400
安排专门人员	an pai zhuan men ren yuan	1367
安全标志	an quan biao zhi	657
安全操作规程	an quan cao zuo gui cheng	1463
安全操作技能	an quan cao zuo ji neng	1434
安全措施的落实	an quan cuo shi de luo shi	1363
安全防护措施	an quan fang hu cuo shi	1430
安全技术特性	an quan ji shu te xing	1431
安全检测	an quan jian ce	981
安全检查与协调	an quan jian cha yu xie tiao	1311
安全检验	an quan jian yan	980
安全警示标志	an quan jing shi biao zhi	1409
安全距离	an quan ju li	1381
安全评价	an quan ping jia	1418
安全评价认证检测检验的工作机构	an quan ping jia ren zheng jian ce jian yan de gong zuo ji gou	773
安全认证	an quan ren zheng	982
安全设备	an quan she bei	680
安全设备的安装使用检测改造和报废不符合国家标准或者行业标准的	an quan she bei de an zhuang shi yong jian ce gai zao he bao fei bu fu he guo jia biao zhun huo zhe hang ye biao zhun de	681
安全设备的设计制造安装使用检测维修改造和报废应当符合国家标准或者行业标准	an quan she bei de she ji zhi zao an zhuang shi yong jian ce wei xiu gai zao he bao fei ying dang fu he guo jia biao zhun huo zhe hang ye biao zhun	1407
安全设备器材	an quan she bei qi cai	1105
安全设施	an quan she shi	1424
安全设施设计	an quan she shi she ji	698
安全设施设计施工	an quan she shi she ji shi gong	1414
安全设施未经验收合格的	an quan she shi wei jing yan shou he ge de	687
安全生产保障	an quan sheng chan bao zhang	1529
安全生产的监督管理	an quan sheng chan de jian du guan li	1526
安全生产法	an quan sheng chan fa	1531
安全生产管理	an quan sheng chan guan li	1510
安全生产管理机构	an quan sheng chan guan li ji gou	1445
安全生产管理人员	an quan sheng chan guan li ren yuan	1438
安全生产管理人员未按照规定经考核合格的	an quan sheng chan guan li ren yuan wei an zhao gui ding jing kao he he ge de	715
安全生产管理协议	an quan sheng chan guan li xie yi	1315
安全生产规章制度	an quan sheng chan gui zhang zhi du	1464
安全生产监督管理部门和负有安全生产监督管理职责的有关部门	an quan sheng chan jian du guan li bu men he fu you an quan sheng chan jian du guan li zhi ze de you guan bu men	408
安全生产监督检查人员	an quan sheng chan jian du jian cha ren yuan	1041
安全生产监督检查人员应当将检查的时间地点内容	an quan sheng chan jian du jian cha ren yuan ying dang jiang jian cha de shi jian de dian nei rong	1018
安全生产监督检查人员应当忠于职守坚持原则秉公执法	an quan sheng chan jian du jian cha ren yuan ying dang zhong yu zhi shou jian chi yuan ze bing gong zhi fa	1036
安全生产监督检查人员执行监督检查任务时必须出示有效的监督执法证件	an quan sheng chan jian du jian cha ren yuan zhi xing jian du jian cha ren wu shi bi xu chu shi you xiao de jian du zhi fa zheng jian	1031
安全生产科学技术研究	an quan sheng chan ke xue ji shu yan jiu	1477
安全生产培训	an quan sheng chan pei xun	1322
安全生产条件	an quan sheng chan tiao jian	1468
安全生产投入	an quan sheng chan tou ru	1462
安全生产违法行为	an quan sheng chan wei fa xing wei	1089
安全生产先进技术的推广应用	an quan sheng chan xian jin ji shu de tui guang ying yong	1476
安全生产宣传教育	an quan sheng chan xuan chuan jiao yu	937
安全生产责任制	an quan sheng chan ze ren zhi	1467
安全生产状况	an quan sheng chan zhuang kuang	1342
安全使用证	an quan shi yong zheng	658
安全条件论证	an quan tiao jian lun zheng	1419
安全问题	an quan wen ti	1338
安全作业培训	an quan zuo ye pei xun	1428
按照规定	an zhao gui ding	708
按照国家有关规定	an zhao guo jia you guan gui ding	890
按照人民政府的批复	an zhao ren min zheng fu de pi fu	159
按照使用规则	an zhao shi yong gui ze	1347
按照职责分工	an zhao zhi ze fen gong	1159
安装	an zhuang	679
安装使用	an zhuang shi yong	675
颁发证照	ban fa zheng zhao	1139
办理工伤社会保险	ban li gong shang she hui bao xian	1263
包庇	bao bi	37
包庇袒护	bao bi tan hu	38
包庇袒护负有事故责任的人员或者借机打击报复的	bao bi tan hu fu you shi gu ze ren de ren yuan huo zhe jie ji da ji bao fu de	57
保持安全距离	bao chi an quan ju li	1382
保持畅通	bao chi chang tong	1377
报废	bao fei	676
报告和调查处理不适用本条例	bao gao he diao cha chu li bu shi yong ben tiao li	499
报告或者举报	bao gao huo zhe ju bao	954
报告事故应当包括下列内容	bao gao shi gu ying dang bao kuo xia lie nei rong	394
报告重大事故隐患	bao gao zhong da shi gu yin huan	945
报经有关部门	bao jing you guan bu men	695
报经有关部门审查同意	bao jing you guan bu men shen cha tong yi	696
报经有关负责人签字	bao jing you guan fu ze ren qian zi	958
包括本数	bao kuo ben shu	471
包括场所和设施	bao kuo chang suo he she shi	518
包括急性工业中毒	bao kuo ji xing gong ye zhong du	492
包括批准核准许可注册认证颁发证照等	bao kuo pi zhun he zhun xu ke zhu ce ren zheng ban fa zheng zhao deng	1144
爆破	bao po	1370
报请县级以上人民政府按照国务院规定的权限决定	bao qing xian ji yi shang ren min zheng fu an zhao guo wu yuan gui ding de quan xian jue ding	559
保守秘密	bao shou mi mi	223
保守事故调查的秘密	bao shou shi gu diao cha de mi mi	225
保障安全生产	bao zhang an quan sheng chan	1490
保障从业人员劳动安全	bao zhang cong ye ren yuan lao dong an quan	1269
保障人民群众生命和财产安全	bao zhang ren min qun zhong sheng ming he cai chan an quan	1519
保证安全生产所必需的资金投入	bao zheng an quan sheng chan suo bi xu de zi jin tou ru	748
保证正常运转	bao zheng zheng chang yun zhuan	907
备案	bei an	1385
被检查单位	bei jian cha dan wei	1046
被检查单位的负责人拒绝签字的检查人员应当将情况记录在案	bei jian cha dan wei de fu ze ren ju jue qian zi de jian cha ren yuan ying dang jiang qing kuang ji lu zai an	1010
被审查验收的单位	bei shen cha yan shou de dan wei	789
本单位	ben dan wei	1465
本单位负责人	ben dan wei fu ze ren	1194
本单位有关负责人	ben dan wei you guan fu ze ren	1330
本法规定的行政处罚由负责安全生产监督管理的部门决定	ben fa gui ding de xing zheng chu fa you fu ze an quan sheng chan jian du guan li de bu men jue ding	561
本条第一款所称的以上包括本数	ben tiao di yi kuan suo cheng de yi shang bao kuo ben shu	472
本条例规定的罚款的行政处罚由安全生产监督管理部门决定	ben tiao li gui ding de fa kuan de xing zheng chu fa you an quan sheng chan jian du guan li bu men jue ding	27
本条例自二七年六月一日起施行	ben tiao li zi er qi nian liu yue yi ri qi shi xing	6
本行政区域内	ben xing zheng qu yu nei	1493
本行政区域内发生生产安全事故的情况	ben xing zheng qu yu nei fa sheng sheng chan an quan shi gu de qing kuang	816
必须按照国家有关规定	bi xu an zhao guo jia you guan gui ding	1402
必须出示	bi xu chu shi	1028
必须出示有效的监督执法证件	bi xu chu shi you xiao de jian du zhi fa zheng jian	1029
必需的资金投入	bi xu de zi jin tou ru	1455
必须具备	bi xu ju bei	1441
必须为从业人员提供符合国家标准或者行业标准的劳动防护用品	bi xu wei cong ye ren yuan ti gong fu he guo jia biao zhun huo zhe hang ye biao zhun de lao dong fang hu yong pin	1352
必须严格依照有关法律法规和国家标准或者行业标准规定的安全生产条件和程序进行审查	bi xu yan ge yi zhao you guan fa lv fa gui he guo jia biao zhun huo zhe hang ye biao zhun gui ding de an quan sheng chan tiao jian he cheng xu jin xing shen cha	1138
必须依法参加工伤社会保险为从业人员缴纳保险费	bi xu yi fa can jia gong shang she hui bao xian wei cong ye ren yuan jiao na bao xian fei	1279
必要的应急救援器材设备	bi yao de ying ji jiu yuan qi cai she bei	912
必要时	bi yao shi	308
必要时安监部门和负有安监职责的有关部门可以越级上报事故情况	bi yao shi an jian bu men he fu you an jian zhi ze de you guan bu men ke yi yue ji shang bao shi gu qing kuang	402
便利条件	bian li tiao jian	443
标志明显	biao zhi ming xian	1376
标志明显保持畅通的出口	biao zhi ming xian bao chi chang tong de chu kou	598
并按照国家有关规定立即如实报告当地负有安全生产监督管理职责的部门	bing an zhao guo jia you guan gui ding li ji ru shi bao gao dang di fu you an quan sheng chan jian du guan li zhi ze de bu men	891
并不得在事故调查处理期间擅离职守	bing bu de zai shi gu diao cha chu li qi jian shan li zhi shou	1285
并对其作出的安全评价认证检测检验的结果负责	bing dui qi zuo chu de an quan ping jia ren zheng jian ce jian yan de jie guo fu ze	976
并对事故责任者提出处理意见	bing dui shi gu ze ren zhe ti chu chu li yi jian	847
并对事故责任者依法追究责任	bing dui shi gu ze ren zhe yi fa zhui jiu ze ren	454
秉公执法	bing gong zhi fa	1032
并进行经常性维护保养保证正常运转	bing jin xing jing chang xing wei hu bao yang bao zheng zheng chang yun zhuan	910
并经取得专业资质的检测检验机构检测检验合格	bing jing qu de zhuan ye zi zhi de jian ce jian yan ji gou jian ce jian yan he ge	1400
并提供必要的便利条件	bing ti gong bi yao de bian li tiao jian	444
并通知公安机关劳动保障行政部门工会和人民检察院	bing tong zhi gong an ji guan lao dong bao zhang xing zheng bu men gong hui he ren min jian cha yuan	417
并向负有安全生产监督管理职责的部门报告	bing xiang fu you an quan sheng chan jian du guan li zhi ze de bu men bao gao	1007
并向社会公布值班电话	bing xiang she hui gong bu zhi ban dian hua	335
并要求其提供相关文件资料	bing yao qiu qi ti gong xiang guan wen jian zi liao	254
并应当随时接受事故调查组的询问	bing ying dang sui shi jie shou shi gu diao cha zu de xun wen	251
并应当邀请人民检察院派人参加	bing ying dang yao qing ren min jian cha yuan pai ren can jia	278
并应当在十五日内依法作出处理决定	bing ying dang zai shi wu ri nei yi fa zuo chu chu li jue ding	1051
并由检查人员和被检查单位的负责人签字	bing you jian cha ren yuan he bei jian cha dan wei de fu ze ren qian zi	1012
并与所调查的事故没有直接利害关系	bing yu suo diao cha de shi gu mei you zhi jie li hai guan xi	270
并指定专职安全生产管理人员进行安全检查与协调	bing zhi ding zhuan zhi an quan sheng chan guan li ren yuan jin xing an quan jian cha yu xie tiao	1313
不包括本数	bu bao kuo ben shu	469
补充规定	bu chong gui ding	473
补充性规定	bu chong xing gui ding	474
不得故意破坏事故现场毁灭有关证据	bu de gu yi po huai shi gu xian chang hui mie you guan zheng ju	882
不得将生产经营项目场所设备	bu de jiang sheng chan jing ying xiang mu chang suo she bei	1310
不得拒绝阻挠	bu de ju jue zu nao	1037
不得批准	bu de pi zhun	1133
不得批准或者验收通过	bu de pi zhun huo zhe yan shou tong guo	1134
不得破坏事故现场毁灭相关证据	bu de po huai shi gu xian chang hui mie xiang guan zheng ju	367
不得擅自发布	bu de shan zi fa bu	219
不得收取费用	bu de shou qu fei yong	1113
不得要求	bu de yao qiu	1110
不得要求接受审查验收的单位	bu de yao qiu jie shou shen cha yan shou de dan wei	1111
不得以任何形式与从业人员订立协议	bu de yi ren he xing shi yu cong ye ren yuan ding li xie yi	1261
不得因从业人员对本单位安全生产工作提出批评检举控告	bu de yin cong ye ren yuan dui ben dan wei an quan sheng chan gong zuo ti chu pi ping jian ju kong gao	1239
不得隐瞒不报	bu de yin man bu bao	886
不得隐瞒不报谎报或者拖延不报	bu de yin man bu bao huang bao huo zhe tuo yan bu bao	887
不得影响	bu de ying xiang	1047
不得阻挠	bu de zu nao	823
不符合安全要求	bu fu he an quan yao qiu	601
不符合保障安全生产的国家标准或者行业标准的	bu fu he bao zhang an quan sheng chan de guo jia biao zhun huo zhe hang ye biao zhun de	1056
不符合法定安全生产条件	bu fu he fa ding an quan sheng chan tiao jian	804
不符合国家标准或者行业标准	bu fu he guo jia biao zhun huo zhe hang ye biao zhun	673
不符合有关法律法规和国家标准或者行业标准规定	bu fu he you guan fa lv fa gui he guo jia biao zhun huo zhe hang ye biao zhun gui ding	1135
不符合有关法律法规和国家标准或者行业标准规定的安全生产条件的	bu fu he you guan fa lv fa gui he guo jia biao zhun huo zhe hang ye biao zhun gui ding de an quan sheng chan tiao jian de	1136
不计入事故调查期限	bu ji ru shi gu diao cha qi xian	231
不接受有关主管部门依法实施的监督管理	bu jie shou you guan zhu guan bu men yi fa shi shi de jian du guan li	636
不具备安全生产条件	bu ju bei an quan sheng chan tiao jian	1302
不立即组织抢救或者在事故调查处理期间擅离职守或者逃匿的	bu li ji zu zhi qiang jiu huo zhe zai shi gu diao cha chu li qi jian shan li zhi shou huo zhe tao ni de	580
不立即组织事故抢救的	bu li ji zu zhi shi gu qiang jiu de	117
不履行监督管理职责	bu lv xing jian du guan li zhi ze	794
不能处理的	bu neng chu li de	1334
不能处理的应当及时报告本单位有关负责人	bu neng chu li de ying dang ji shi bao gao ben dan wei you guan fu ze ren	1335
不依法予以处理	bu yi fa yu yi chu li	796
不依照本法规定保证安全生产所必需的资金投入	bu yi zhao ben fa gui ding bao zheng an quan sheng chan suo bi xu de zi jin tou ru	749
不再具备安全生产条件	bu zai ju bei an quan sheng chan tiao jian	1119
不再具备安全生产条件而不撤销原批准	bu zai ju bei an quan sheng chan tiao jian er bu che xiao yuan pi zhun	792
财产	cai chan	96
财产安全	cai chan an quan	523
财产损失	cai chan sun shi	892
采取多种形式	cai qu duo zhong xing shi	1486
采取紧急撤离措施	cai qu jin ji che li cuo shi	1224
采取可靠的安全措施	cai qu ke kao de an quan cuo shi	1391
采取可能的应急措施	cai qu ke neng de ying ji cuo shi	1228
采取强制措施	cai qu qiang zhi cuo shi	343
采取强制措施和侦查措施	cai qu qiang zhi cuo shi he zhen cha cuo shi	348
采取有效措施	cai qu you xiao cuo shi	895
采取有效措施组织抢救防止事故扩大减少人员伤亡和财产损失	cai qu you xiao cuo shi zu zhi qiang jiu fang zhi shi gu kuo da jian shao ren yuan shang wang he cai chan sun shi	377
参加事故调查处理的部门和单位	can jia shi gu diao cha chu li de bu men he dan wei	442
参与调查	can yu diao cha	274
参与事故调查的人员在事故调查中有下列行为之一的依法给予处分	can yu shi gu diao cha de ren yuan zai shi gu diao cha zhong you xia lie xing wei zhi yi de yi fa ji yu chu fen	60
参照本条例的规定执行	can zhao ben tiao li de gui ding zhi xing	13
操作规程	cao zuo gui cheng	1362
查明关事项	cha ming guan shi xiang	832
查明事故单位责任	cha ming shi gu dan wei ze ren	835
查明事故发生的经过原因人员伤亡情况及直接经济损失	cha ming shi gu fa sheng de jing guo yuan yin ren yuan shang wang qing kuang ji zhi jie jing ji sun shi	261
查明事故性质	cha ming shi gu xing zhi	456
查明事故性质和责任	cha ming shi gu xing zhi he ze ren	854
查清事故原因	cha qing shi gu yuan yin	856
长期地或者临时地生产搬运使用或者储存危险物品	chang qi de huo zhe lin shi de sheng chan ban yun shi yong huo zhe chu cun wei xian wu pin	522
场所	chang suo	1307
超过临界量	chao guo lin jie liang	519
超过临界量的单元	chao guo lin jie liang de dan yuan	520
撤出作业人员	che chu zuo ye ren yuan	1068
车间商店仓库	che jian shang dian cang ku	605
撤离危险场所	che li wei xian chang suo	1170
撤离作业场所	che li zuo ye chang suo	1227
撤销其相应资格	che xiao qi xiang ying zi ge	753
撤职处分	che zhi chu fen	46
承包单位	cheng bao dan wei	1297
承包合同	cheng bao he tong	1292
承包合同租赁合同中明确各自的安全生产管理职责	cheng bao he tong zu lin he tong zhong ming que ge zi de an quan sheng chan guan li zhi ze	615
承担安全评价认证检测检验的机构	cheng dan an quan ping jia ren zheng jian ce jian yan de ji gou	986
承担安全评价认证检测检验的机构应当具备国家规定的资质条件	cheng dan an quan ping jia ren zheng jian ce jian yan de ji gou ying dang ju bei guo jia gui ding de zi zhi tiao jian	987
承担安全评价认证检测检验工作的机构	cheng dan an quan ping jia ren zheng jian ce jian yan gong zuo de ji gou	774
承担连带赔偿责任	cheng dan lian dai pei chang ze ren	757
承担责任	cheng dan ze ren	1448
诚信公正	cheng xin gong zheng	228
承租单位	cheng zu dan wei	1296
迟报	chi bao	463
迟报或者漏报事故的	chi bao huo zhe lou bao shi gu de	116
迟报漏报谎报或者瞒报事故的	chi bao lou bao huang bao huo zhe man bao shi gu de	73
初步估计	chu bu gu ji	386
初步估计的直接经济损失	chu bu gu ji de zhi jie jing ji sun shi	389
出具虚假证明	chu ju xu jia zheng ming	770
出具虚假证明构成犯罪的	chu ju xu jia zheng ming gou cheng fan zui de	771
除了应当查明事故单位的责任并依法予以追究外	chu le ying dang cha ming shi gu dan wei de ze ren bing yi fa yu yi zhui jiu wai	836
处理建议	chu li jian yi	192
处理情况	chu li qing kuang	1015
处理意见	chu li yi jian	845
处上一年年收入百分之四十至百分之八十的罚款	chu shang yi nian nian shou ru bai fen zhi si shi zhi bai fen zhi ba shi de fa kuan	125
处上一年年收入六十至百分之百的罚款	chu shang yi nian nian shou ru liu shi zhi bai fen zhi bai de fa kuan	111
除外	chu wai	127
处置废弃危险物品	chu zhi fei qi wei xian wu pin	1393
出租	chu zu	1303
从事生产经营活动的单位	cong shi sheng chan jing ying huo dong de dan wei	1516
从业人员	cong ye ren yuan	1528
从业人员发现直接危及人身安全的紧急情况时	cong ye ren yuan fa xian zhi jie wei ji ren shen an quan de jin ji qing kuang shi	1233
从业人员有权了解其作业场所和工作岗位存在的危险因素防范措施事故应急措施	cong ye ren yuan you quan liao jie qi zuo ye chang suo he gong zuo gang wei cun zai de wei xian yin su fang fan cuo shi shi gu ying ji cuo shi	1254
从业人员在作业过程中应当严格遵守本单位的安全生产规章制度和操作规程	cong ye ren yuan zai zuo ye guo cheng zhong ying dang yan ge zun shou ben dan wei de an quan sheng chan gui zhang zhi du he cao zuo gui cheng	1212
促进经济发展	cu jin jing ji fa zhan	1518
村民委员会	cun min wei yuan hui	952
存在的危险因素	cun zai de wei xian yin su	1251
存在的问题	cun zai de wen ti	1247
存在事故隐患	cun zai shi gu yin huan	949
待遇	dai yu	1235
单处或者并处	dan chu huo zhe bing chu	760
单处或者并处二万元以上十万元以下的罚款	dan chu huo zhe bing chu er wan yuan yi shang shi wan yuan yi xia de fa kuan	642
单处或者并处五千元以上二万元以下的罚款	dan chu huo zhe bing chu wu qian yuan yi shang er wan yuan yi xia de fa kuan	761
但是社会影响恶劣的事故	dan shi she hui ying xiang e lie de shi gu	18
单位的主要负责人	dan wei de zhu yao fu ze ren	1283
单位负责人接到报告后应当于一小时内	dan wei fu ze ren jie dao bao gao hou ying dang yu yi xiao shi nei	431
单位负责人接到事故报告后	dan wei fu ze ren jie dao shi gu bao gao hou	899
单位概况	dan wei gai kuang	199
单位和个人	dan wei he ge ren	1470
单位或者个人	dan wei huo zhe ge ren	1300
但延长的期限最长不超过六十日	dan yan chang de qi xian zui chang bu chao guo liu shi ri	211
当场予以纠正	dang chang yu yi jiu zheng	1088
当地负有安全生产监督管理职责的部门	dang di fu you an quan sheng chan jian du guan li zhi ze de bu men	888
当及时补报	dang ji shi bu bao	382
道路交通安全	dao lu jiao tong an quan	1514
道路交通事故	dao lu jiao tong shi gu	307
道路交通事故火灾事故自发生之日起七日内	dao lu jiao tong shi gu huo zai shi gu zi fa sheng zhi ri qi qi ri nei	379
导致	dao zhi	299
导致的后果	dao zhi de hou guo	1449
导致发生生产安全事故	dao zhi fa sheng sheng chan an quan shi gu	620
导致发生生产安全事故给他人造成损害的与承包方承租方承担连带赔偿责任	dao zhi fa sheng sheng chan an quan shi gu gei ta ren zao cheng sun hai de yu cheng bao fang cheng zu fang cheng dan lian dai pei chang ze ren	621
导致发生生产安全事故构成犯罪的	dao zhi fa sheng sheng chan an quan shi gu gou cheng fan zui de	737
导致事故等级发生变化	dao zhi shi gu deng ji fa sheng bian hua	303
登记建档	deng ji jian dang	1388
地方各级人民政府应当加强对安全生产工作的领导	di fang ge ji ren min zheng fu ying dang jia qiang dui an quan sheng chan gong zuo de ling dao	1499
调查程序	diao cha cheng xu	4
调查处理	diao cha chu li	1522
调查核实	diao cha he shi	964
调查确定	diao cha que ding	838
吊销	diao xiao	54
调阅有关资料	diao yue you guan zi liao	1093
吊装	diao zhuang	1369
订立的劳动合同	ding li de lao dong he tong	1273
订立协议	ding li xie yi	1259
定期检测	ding qi jian ce	671
定期检测评估监控	ding qi jian ce ping gu jian kong	1387
定期统计分析	ding qi tong ji fen xi	818
定期向社会公布	ding qi xiang she hui gong bu	815
督促检查	du cu jian cha	1460
督促落实	du cu luo shi	957
对安全生产负有监督管理职责的部门	dui an quan sheng chan fu you jian du guan li zhi ze de bu men	1152
对安全生产状况进行经常性检查	dui an quan sheng chan zhuang kuang jin xing jing chang xing jian cha	1343
对报告重大事故隐患或者举报安全生产违法行为的有功人员给予奖励	dui bao gao zhong da shi gu yin huan huo zhe ju bao an quan sheng chan wei fa xing wei de you gong ren yuan gei yu jiang li	946
对本单位负有事故责任的人员进行处理	dui ben dan wei fu you shi gu ze ren de ren yuan jin xing chu li	152
对本行政区域内容易发生重大生产安全事故的生产经营单位进行严格检查	dui ben xing zheng qu yu nei rong yi fa sheng zhong da sheng chan an quan shi gu de sheng chan jing ying dan wei jin xing yan ge jian cha	1158
对不符合法定安全生产条件的涉及安全生产的事项予以批准或者验收通过的	dui bu fu he fa ding an quan sheng chan tiao jian de she ji an quan sheng chan de shi xiang yu yi pi zhun huo zhe yan shou tong guo de	805
对负有安全生产监督管理职责的部门及其工作人员履行安全生产监督管理职责实施监察	dui fu you an quan sheng chan jian du guan li zhi ze de bu men ji qi gong zuo ren yuan lv xing an quan sheng chan jian du guan li zhi ze shi shi jian cha	990
对负有事故责任的国家工作人员进行处分	dui fu you shi gu ze ren de guo jia gong zuo ren yuan jin xing chu fen	161
对个人经营的投资人处二万元以上二十万元以下的罚款	dui ge ren jing ying de tou zi ren chu er wan yuan yi shang er shi wan yuan yi xia de fa kuan	734
对检查中发现的安全生产违法行为当场予以纠正或者要求限期改正	dui jian cha zhong fa xian de an quan sheng chan wei fa xing wei dang chang yu yi jiu zheng huo zhe yao qiu xian qi gai zheng	1090
对检查中发现的安全问题应当立即处理	dui jian cha zhong fa xian de an quan wen ti ying dang li ji chu li	1340
对检查中发现的事故隐患应当责令立即排除	dui jian cha zhong fa xian de shi gu yin huan ying dang ze ling li ji pai chu	1078
对其直接负责的主管人员和其他直接责任人员处五千元以上五万元以下的罚款	dui qi zhi jie fu ze de zhu guan ren yuan he qi ta zhi jie ze ren ren yuan chu wu qian yuan yi shang wu wan yuan yi xia de fa kuan	759
对涉及安全生产的事项需要审查批准或者验收的	dui she ji an quan sheng chan de shi xiang xu yao shen cha pi zhun huo zhe yan shou de	1149
对涉及被检查单位的技术秘密和业务秘密应当为其保密	dui she ji bei jian cha dan wei de ji shu mi mi he ye wu mi mi ying dang wei qi bao mi	1024
对涉嫌犯罪的应当依法立案侦查	dui she xian fan zui de ying dang yi fa li an zhen cha	349
对生产安全事故隐瞒不报谎报或者拖延不报的	dui sheng chan an quan shi gu yin man bu bao huang bao huo zhe tuo yan bu bao de	572
对生产经营单位的主要负责人个人经营的投资人处二万元以上十万元以下的罚款	dui sheng chan jing ying dan wei de zhu yao fu ze ren ge ren jing ying de tou zi ren chu er wan yuan yi shang shi wan yuan yi xia de fa kuan	592
对生产经营单位的主要负责人给予撤职处分	dui sheng chan jing ying dan wei de zhu yao fu ze ren gei yu che zhi chu fen	735
对事故报告和调查处理中的违法行为	dui shi gu bao gao he diao cha chu li zhong de wei fa xing wei	437
对事故调查工作不负责任	dui shi gu diao cha gong zuo bu fu ze ren	59
对事故发生单位处一百万元以上五百万元以下的罚款	dui shi gu fa sheng dan wei chu yi bai wan yuan yi shang wu bai wan yuan yi xia de fa kuan	113
对事故发生单位负有事故责任的有关人员	dui shi gu fa sheng dan wei fu you shi gu ze ren de you guan ren yuan	67
对事故发生单位和有关人员进行行政处罚	dui shi gu fa sheng dan wei he you guan ren yuan jin xing xing zheng chu fa	162
对事故情况不得隐瞒不报谎报或者拖延不报	dui shi gu qing kuang bu de yin man bu bao huang bao huo zhe tuo yan bu bao	875
对逃匿的处十五日以下拘留	dui tao ni de chu shi wu ri yi xia ju liu	575
对未依法取得批准或者验收合格的单位擅自从事有关活动的	dui wei yi fa qu de pi zhun huo zhe yan shou he ge de dan wei shan zi cong shi you guan huo dong de	1131
对依法应当给予行政处罚的行为	dui yi fa ying dang ji yu xing zheng chu fa de xing wei	1086
对已经依法取得批准的单位	dui yi jing yi fa qu de pi zhun de dan wei	1122
对已经依法取得批准的单位不履行监督管理职责	dui yi jing yi fa qu de pi zhun de dan wei bu lv xing jian du guan li zhi ze	795
对有根据认为不符合保障安全生产的国家标准或者行业标准的	dui you gen ju ren wei bu fu he bao zhang an quan sheng chan de guo jia biao zhun huo zhe hang ye biao zhun de	1059
对有关的安全生产工作实施监督管理	dui you guan de an quan sheng chan gong zuo shi shi jian du guan li	1492
对有前款违法行为的机构撤销其相应资格	dui you qian kuan wei fa xing wei de ji gou che xiao qi xiang ying zi ge	754
对有失职渎职行为的	dui you shi zhi du zhi xing wei de	829
对直接负责的主管人员	dui zhi jie fu ze de zhu guan ren yuan	777
对直接负责的主管人员和其他直接责任人员依法给予处分	dui zhi jie fu ze de zhu guan ren yuan he qi ta zhi jie ze ren ren yuan yi fa ji yu chu fen	74
对重大危险源未登记建档或者未进行评估监控或者未制定应急预案的	dui zhong da wei xian yuan wei deng ji jian dang huo zhe wei jin xing ping gu jian kong huo zhe wei zhi ding ying ji yu an de	634
对主要负责人直接负责的主管人员和其他直接责任人员	dui zhu yao fu ze ren zhi jie fu ze de zhu guan ren yuan he qi ta zhi jie ze ren ren yuan	112
多个承包单位	duo ge cheng bao dan wei	1298
二七年三月二十八日国务院第一七二次常务会议通过	er qi nian san yue er shi ba ri guo wu yuan di yi qi er ci chang wu hui yi tong guo	515
发包	fa bao	1304
发包或者出租给不具备安全生产条件或者相应资质的单位或者个人	fa bao huo zhe chu zu gei bu ju bei an quan sheng chan tiao jian huo zhe xiang ying zi zhi de dan wei huo zhe ge ren	1305
法律	fa lv	25
法律法规	fa lv fa gui	1100
法律行政法规对行政处罚的种类幅度和决定机关另有规定的	fa lv xing zheng fa gui dui xing zheng chu fa de zhong lei fu du he jue ding ji guan ling you gui ding de	26
法律责任	fa lv ze ren	1521
发生变化	fa sheng bian hua	297
发生的事故的报告和调查处理	fa sheng de shi gu de bao gao he diao cha chu li	9
发生较大事故的处二十万元以上五十万元以下的罚款	fa sheng jiao da shi gu de chu er shi wan yuan yi shang wu shi wan yuan yi xia de fa kuan	84
发生较大事故的处上一年年收入四十的罚款	fa sheng jiao da shi gu de chu shang yi nian nian shou ru si shi de fa kuan	78
发生经过	fa sheng jing guo	198
发生生产安全事故	fa sheng sheng chan an quan shi gu	904
发生特别重大事故的处二百万元以上五百万元以下的罚款	fa sheng te bie zhong da shi gu de chu er bai wan yuan yi shang wu bai wan yuan yi xia de fa kuan	82
发生特别重大事故的处上一年年收入八十的罚款	fa sheng te bie zhong da shi gu de chu shang yi nian nian shou ru ba shi de fa kuan	76
发生一般事故的处上一年年收入三十的罚款	fa sheng yi ban shi gu de chu shang yi nian nian shou ru san shi de fa kuan	79
发生一般事故的处十万元以上二十万元以下的罚款	fa sheng yi ban shi gu de chu shi wan yuan yi shang er shi wan yuan yi xia de fa kuan	85
发生原因	fa sheng yuan yin	195
发生重大生产安全事故	fa sheng zhong da sheng chan an quan shi gu	1284
发生重大生产安全事故时单位的主要负责人应当立即组织抢救	fa sheng zhong da sheng chan an quan shi gu shi dan wei de zhu yao fu ze ren ying dang li ji zu zhi qiang jiu	1286
发生重大事故的处上一年年收入六十的罚款	fa sheng zhong da shi gu de chu shang yi nian nian shou ru liu shi de fa kuan	77
发生重大事故的处五十万元以上二百万元以下的罚款	fa sheng zhong da shi gu de chu wu shi wan yuan yi shang er bai wan yuan yi xia de fa kuan	83
发现安全生产违法行为不予查处	fa xian an quan sheng chan wei fa xing wei bu yu cha chu	791
发现存在的安全问题应当由其他有关部门进行处理的	fa xian cun zai de an quan wen ti ying dang you qi ta you guan bu men jin xing chu li de	999
发现的问题及其处理情况作出书面记录	fa xian de wen ti ji qi chu li qing kuang zuo chu shu mian ji lu	1016
发现或者接到举报	fa xian huo zhe jie dao ju bao	1125
发现其不再具备安全生产条件而不撤销原批准或者发现安全生产违法行为不予查处的	fa xian qi bu zai ju bei an quan sheng chan tiao jian er bu che xiao yuan pi zhun huo zhe fa xian an quan sheng chan wei fa xing wei bu yu cha chu de	793
发现其所在区域内的生产经营单位存在事故隐患或者安全生产违法行为时	fa xian qi suo zai qu yu nei de sheng chan jing ying dan wei cun zai shi gu yin huan huo zhe an quan sheng chan wei fa xing wei shi	951
发现生产经营单位违章指挥强令冒险作业或者发现事故隐患时	fa xian sheng chan jing ying dan wei wei zhang zhi hui qiang ling mao xian zuo ye huo zhe fa xian shi gu yin huan shi	1178
发现事故隐患	fa xian shi gu yin huan	1197
发现事故隐患或者其他不安全因素	fa xian shi gu yin huan huo zhe qi ta bu an quan yin su	1199
发现事故隐患应当及时处理	fa xian shi gu yin huan ying dang ji shi chu li	1154
发现危及从业人员生命安全的情况时有权向生产经营单位建议	fa xian wei ji cong ye ren yuan sheng ming an quan de qing kuang shi you quan xiang sheng chan jing ying dan wei jian yi	1173
发现未依法取得批准验收的单位	fa xian wei yi fa qu de pi zhun yan shou de dan wei	801
犯罪嫌疑人逃匿	fan zui xian yi ren tao ni	340
犯罪嫌疑人逃匿的公安机关应当迅速追捕归案	fan zui xian yi ren tao ni de gong an ji guan ying dang xun su zhui bu gui an	347
防范措施	fang fan cuo shi	1354
防范和整改措施	fang fan he zheng gai cuo shi	140
防范和整改措施的落实情况应当接受工会和职工的监督	fang fan he zheng gai cuo shi de luo shi qing kuang ying dang jie shou gong hui he zhi gong de jian du	145
方可恢复生产经营和使用	fang ke hui fu sheng chan jing ying he shi yong	1060
方可投入使用	fang ke tou ru shi yong	1398
放射性物品	fang she xing wu pin	526
防止和减少生产安全事故	fang zhi he jian shao sheng chan an quan shi gu	507
防止生产安全事故	fang zhi sheng chan an quan shi gu	1473
防止事故	fang zhi shi gu	142
防止事故扩大	fang zhi shi gu kuo da	894
防止事故再次发生	fang zhi shi gu zai ci fa sheng	146
防止职业危害	fang zhi zhi ye wei hai	1266
防止职业危害的事项	fang zhi zhi ye wei hai de shi xiang	1267
分别进行检查	fen bie jin xing jian cha	1001
分别由事故发生地	fen bie you shi gu fa sheng di	324
封闭堵塞	feng bi du se	1374
封闭堵塞生产经营场所或者员工宿舍出口	feng bi du se sheng chan jing ying chang suo huo zhe yuan gong su she chu kou	597
服从管理	fu cong guan li	1208
服从管理正确佩戴和使用劳动防护用品	fu cong guan li zheng que pei dai he shi yong lao dong fang hu yong pin	1209
符合国家标准	fu he guo jia biao zhun	1351
附具	fu ju	188
复印件	fu yin jian	243
负有安全生产监督管理职责的部门	fu you an quan sheng chan jian du guan li zhi ze de bu men	1151
负有安全生产监督管理职责的部门的工作人员	fu you an quan sheng chan jian du guan li zhi ze de bu men de gong zuo ren yuan	814
负有安全生产监督管理职责的部门的监督检查人员	fu you an quan sheng chan jian du guan li zhi ze de bu men de jian du jian cha ren yuan	1043
负有安全生产监督管理职责的部门对涉及安全生产的事项进行审查验收不得收取费用	fu you an quan sheng chan jian du guan li zhi ze de bu men dui she ji an quan sheng chan de shi xiang jin xing shen cha yan shou bu de shou qu fei yong	1117
负有安全生产监督管理职责的部门和有关地方人民政府	fu you an quan sheng chan jian du guan li zhi ze de bu men he you guan di fang ren min zheng fu	876
负有安全生产监督管理职责的部门接到事故报告后	fu you an quan sheng chan jian du guan li zhi ze de bu men jie dao shi gu bao gao hou	879
负有安全生产监督管理职责的部门应当建立举报制度	fu you an quan sheng chan jian du guan li zhi ze de bu men ying dang jian li ju bao zhi du	975
负有安全生产监督管理职责的部门在监督检查中应当互相配合实行联合检查	fu you an quan sheng chan jian du guan li zhi ze de bu men zai jian du jian cha zhong ying dang hu xiang pei he shi xing lian he jian cha	1006
负有安全生产监督管理职责的有关部门	fu you an quan sheng chan jian du guan li zhi ze de you guan bu men	426
负有安全生产监督管理职责的有关部门报告	fu you an quan sheng chan jian du guan li zhi ze de you guan bu men bao gao	425
负有审查批准和监督职责	fu you shen cha pi zhun he jian du zhi ze	831
负有事故责任的国家工作人员	fu you shi gu ze ren de guo jia gong zuo ren yuan	155
负有事故责任的人员涉嫌犯罪的依法追究刑事责任	fu you shi gu ze ren de ren yuan she xian fan zui de yi fa zhui jiu xing shi ze ren	151
负有事故责任的有关人员	fu you shi gu ze ren de you guan ren yuan	53
附则	fu ze	530
负责安全生产监督管理的部门	fu ze an quan sheng chan jian du guan li de bu men	1494
负责调查	fu ze diao cha	322
负责人签字	fu ze ren qian zi	1011
负责人逃匿	fu ze ren tao ni	548
负责事故调查的人民政府	fu ze shi gu diao cha de ren min zheng fu	178
负责行政审批的部门	fu ze xing zheng shen pi de bu men	1126
负责行政审批的部门发现或者接到举报后应当立即予以取缔并依法予以处理	fu ze xing zheng shen pi de bu men fa xian huo zhe jie dao ju bao hou ying dang li ji yu yi qu di bing yi fa yu yi chu li	1127
负责行政审批的部门发现其不再具备安全生产条件的应当撤销原批准	fu ze xing zheng shen pi de bu men fa xian qi bu zai ju bei an quan sheng chan tiao jian de ying dang che xiao yuan pi zhun	1120
改善安全生产条件	gai shan an quan sheng chan tiao jian	1474
该协议无效	gai xie yi wu xiao	593
改造	gai zao	677
干涉	gan she	70
干涉对事故的依法调查处理	gan she dui shi gu de yi fa diao cha chu li	822
岗位证书	gang wei zheng shu	48
告知从业人员和相关人员在紧急情况下应当采取的应急措施	gao zhi cong ye ren yuan he xiang guan ren yuan zai jin ji qing kuang xia ying dang cai qu de ying ji cuo shi	1386
个人经营	ge ren jing ying	751
个人经营的投资人	ge ren jing ying de tou zi ren	591
个人经营投资人	ge ren jing ying tou zi ren	1452
各自的安全生产管理职责	ge zi de an quan sheng chan guan li zhi ze	1289
给他人造成损害	gei ta ren zao cheng sun hai	619
给他人造成损害的与生产经营单位承担连带赔偿责任	gei ta ren zao cheng sun hai de yu sheng chan jing ying dan wei cheng dan lian dai pei chang ze ren	758
给予撤职处分	gei yu che zhi chu fen	728
给予降级撤职	gei yu jiang ji che zhi	811
给予降级或者撤职的行政处分	gei yu jiang ji huo zhe che zhi de xing zheng chu fen	812
给予奖励	gei yu jiang li	1469
给予降职撤职的处分	gei yu jiang zhi che zhi de chu fen	576
给予拘留的行政处罚由公安机关依照治安管理处罚条例的规定决定	gei yu ju liu de xing zheng chu fa you gong an ji guan yi zhao zhi an guan li chu fa tiao li de gui ding jue ding	557
给予行政处罚	gei yu xing zheng chu fa	1085
给予足额赔偿	gei yu zu e pei chang	538
根据本单位的生产经营特点	gen ju ben dan wei de sheng chan jing ying te dian	1345
根据本行政区域内	gen ju ben xing zheng qu yu nei	1162
根据生产安全事故造成的人员伤亡或者直接经济损失	gen ju sheng chan an quan shi gu zao cheng de ren yuan shang wang huo zhe zhi jie jing ji sun shi	498
根据事故的具体情况	gen ju shi gu de ju ti qing kuang	283
根据中华人民共和国安全生产法和有关法律制定本条例	gen ju zhong hua ren min gong he guo an quan sheng chan fa he you guan fa lv zhi ding ben tiao li	506
公安机关	gong an ji guan	416
公布施行	gong bu shi xing	513
公布值班电话	gong bu zhi ban dian hua	334
工程技术人员	gong cheng ji shu ren yuan	1442
工程质量	gong cheng zhi liang	1413
工会	gong hui	414
工会对生产经营单位违反安全生产法律法规侵犯从业人员合法权益的行为	gong hui dui sheng chan jing ying dan wei wei fan an quan sheng chan fa lv fa gui qin fan cong ye ren yuan he fa quan yi de xing wei	1183
工会依法参加事故调查处理有权向有关部门提出处理意见	gong hui yi fa can jia shi gu diao cha chu li you quan xiang you guan bu men ti chu chu li yi jian	439
工会依法组织职工参加本单位安全生产工作的民主管理和民主监督	gong hui yi fa zu zhi zhi gong can jia ben dan wei an quan sheng chan gong zuo de min zhu guan li he min zhu jian du	1501
工会有权对建设项目的安全设施与主体工程三同时投入生产和使用进行监督提出意见	gong hui you quan dui jian she xiang mu de an quan she shi yu zhu ti gong cheng san tong shi tou ru sheng chan he shi yong jin xing jian du ti chu yi jian	1190
工会有权依法参加事故调查向有关部门提出处理意见并要求追究有关人员的责任	gong hui you quan yi fa can jia shi gu diao cha xiang you guan bu men ti chu chu li yi jian bing yao qiu zhui jiu you guan ren yuan de ze ren	1167
公开举报电话信箱或者电子邮件地址	gong kai ju bao dian hua xin xiang huo zhe dian zi you jian di zhi	972
工伤社会保险	gong shang she hui bao xian	1277
工艺设备	gong yi she bei	651
工资福利	gong zi fu li	1236
工作岗位	gong zuo gang wei	1356
工作机构	gong zuo ji gou	772
构成犯罪	gou cheng fan zui	769
构成犯罪的	gou cheng fan zui de	808
构成犯罪的依法追究刑事责任	gou cheng fan zui de yi fa zhui jiu xing shi ze ren	118
构成犯罪的依照刑法有关规定追究刑事责任	gou cheng fan zui de yi zhao xing fa you guan gui ding zhui jiu xing shi ze ren	809
构成违反治安管理行为的	gou cheng wei fan zhi an guan li xing wei de	110
购买其指定的安全设备器材或者其他产品	gou mai qi zhi ding de an quan she bei qi cai huo zhe qi ta chan pin	788
购买其指定品牌	gou mai qi zhi ding pin pai	1107
购买其指定品牌或者指定生产销售单位的安全设备器材或者其他产品	gou mai qi zhi ding pin pai huo zhe zhi ding sheng chan xiao shou dan wei de an quan she bei qi cai huo zhe qi ta chan pin	1108
故意破坏	gu yi po huai	103
故意破坏事故现场	gu yi po huai shi gu xian chang	881
故意拖延	gu yi tuo yan	31
故意拖延或者拒绝落实经批复的对事故责任人的处理意见的	gu yi tuo yan huo zhe ju jue luo shi jing pi fu de dui shi gu ze ren ren de chu li yi jian de	32
广播电影电视	guang bo dian ying dian shi	938
归档保存	gui dang bao cun	174
规范生产安全事故的报告和调查处理	gui fan sheng chan an quan shi gu de bao gao he diao cha chu li	509
规模较小	gui mo jiao xiao	918
规章制度	gui zhang zhi du	585
国防科研生产事故	guo fang ke yan sheng chan shi gu	500
国家标准	guo jia biao zhun	1489
国家标准或者行业标准的情况进行监督检查行使以下职权	guo jia biao zhun huo zhe hang ye biao zhun de qing kuang jin xing jian du jian cha xing shi yi xia zhi quan	1099
国家对严重危及生产安全的工艺设备实行淘汰制度	guo jia dui yan zhong wei ji sheng chan an quan de gong yi she bei shi xing tao tai zhi du	1395
国家工作人员	guo jia gong zuo ren yuan	120
国家机关	guo jia ji guan	12
国家机关事业单位人民团体发生的事故的报告和调查处理	guo jia ji guan shi ye dan wei ren min tuan ti fa sheng de shi gu de bao gao he diao cha chu li	14
国家明令淘汰	guo jia ming ling tao tai	654
国务院安全生产监督管理部门	guo wu yuan an quan sheng chan jian du guan li bu men	478
国务院安全生产监督管理部门和负有安全生产监督管理职责的有关部门	guo wu yuan an quan sheng chan jian du guan li bu men he fu you an quan sheng chan jian du guan li zhi ze de you guan bu men	405
国务院或者有关地方人民政府认为需要调查处理的	guo wu yuan huo zhe you guan di fang ren min zheng fu ren wei xu yao diao cha chu li de	17
国务院一九八九年三月二十九日公布的特别重大事故调查程序暂行规定	guo wu yuan yi jiu ba jiu nian san yue er shi jiu ri gong bu de te bie zhong da shi gu diao cha cheng xu zan xing gui ding	5
国务院有关部门	guo wu yuan you guan bu men	476
国务院制定	guo wu yuan zhi ding	841
还应当查明对安全生产的有关事项负有审查批准和监督职责的行政部门的责任	hai ying dang cha ming dui an quan sheng chan de you guan shi xiang fu you shen cha pi zhun he jian du zhi ze de xing zheng bu men de ze ren	833
行业标准	hang ye biao zhun	1488
和负有安全生产监督管理职责的有关部门	he fu you an quan sheng chan jian du guan li zhi ze de you guan bu men	411
和负有安全生产监督管理职责的有关部门报告	he fu you an quan sheng chan jian du guan li zhi ze de you guan bu men bao gao	421
和国家标准或者行业标准规定的安全生产条件	he guo jia biao zhun huo zhe hang ye biao zhun gui ding de an quan sheng chan tiao jian	567
核设施事故	he she shi shi gu	501
核准	he zhun	1143
痕迹	hen ji	354
互通情况	hu tong qing kuang	1000
互相配合	hu xiang pei he	1005
护职工在安全生产方面的合法权益	hu zhi gong zai an quan sheng chan fang mian de he fa quan yi	1500
环境污染事故	huan jing wu ran shi gu	502
谎报	huang bao	884
谎报或者瞒报事故的	huang bao huo zhe man bao shi gu de	106
毁灭相关证据	hui mie xiang guan zheng ju	366
毁灭有关证据	hui mie you guan zheng ju	880
毁灭证据	hui mie zheng ju	365
绘制	hui zhi	357
绘制现场简图	hui zhi xian chang jian tu	359
获得赔偿的权利	huo de pei chang de quan li	1215
火灾事故	huo zai shi gu	306
或者	huo zhe	131
或者其授权的有关部门机构向社会公布	huo zhe qi shou quan de you guan bu men ji gou xiang she hui gong bu	134
或者受处分之日起五年内不得担任任何生产经营单位的主要负责人	huo zhe shou chu fen zhi ri qi wu nian nei bu de dan ren ren he sheng chan jing ying dan wei de zhu yao fu ze ren	63
或者未对承包单位承租单位的安全生产统一协调管理的	huo zhe wei dui cheng bao dan wei cheng zu dan wei de an quan sheng chan tong yi xie tiao guan li de	613
或者未在承包合同租赁合同中明确各自的安全生产管理职责	huo zhe wei zai cheng bao he tong zu lin he tong zhong ming que ge zi de an quan sheng chan guan li zhi ze	616
或者在承包合同租赁合同中约定各自的安全生产管理职责	huo zhe zai cheng bao he tong zu lin he tong zhong yue ding ge zi de an quan sheng chan guan li zhi ze	1293
即告结束	ji gao jie shu	177
记录在案	ji lu zai an	1325
及时	ji shi	467
及时报告	ji shi bao gao	1332
及时报送	ji shi bao song	179
及时如实报告生产安全事故	ji shi ru shi bao gao sheng chan an quan shi gu	1456
及时消除生产安全事故隐患	ji shi xiao chu sheng chan an quan shi gu yin huan	1459
及时研究答复	ji shi yan jiu da fu	1174
及时移送	ji shi yi song	997
及时予以处理	ji shi yu yi chu li	1191
及时予以协调解决	ji shi yu yi xie tiao jie jue	1497
及时准确	ji shi zhun que	857
及时准确地查清	ji shi zhun que de cha qing	459
及时准确地查清事故原因	ji shi zhun que de cha qing shi gu yuan yin	858
及时准确地完成事故调查处理工作	ji shi zhun que de wan cheng shi gu diao cha chu li gong zuo	449
技术鉴定	ji shu jian ding	239
技术鉴定所需时间不计入事故调查期限	ji shu jian ding suo xu shi jian bu ji ru shi gu diao cha qi xian	234
技术秘密	ji shu mi mi	1022
急性工业中毒	ji xing gong ye zhong du	491
继续履行	ji xu lv xing	535
给予处分	ji yu chu fen	584
加强安全生产管理	jia qiang an quan sheng chan guan li	1508
加强对有关安全生产的法律法规和安全生产知识的宣传	jia qiang dui you guan an quan sheng chan de fa lv fa gui he an quan sheng chan zhi shi de xuan chuan	1485
检测	jian ce	984
检测改造	jian ce gai zao	674
检测合格	jian ce he ge	661
检测检验合格	jian ce jian yan he ge	662
检测检验机构对检测检验结果负责	jian ce jian yan ji gou dui jian ce jian yan jie guo fu ze	1397
检查的时间地点内容	jian cha de shi jian de dian nei rong	1017
检查及处理	jian cha ji chu li	1328
检查及处理情况	jian cha ji chu li qing kuang	1327
检查及处理情况应当记录在案	jian cha ji chu li qing kuang ying dang ji lu zai an	1329
监察机关	jian cha ji guan	992
监察机关公安机关以及工会派人组成	jian cha ji guan gong an ji guan yi ji gong hui pai ren zu cheng	280
监察机关依照行政监察法的规定	jian cha ji guan yi zhao xing zheng jian cha fa de gui ding	993
检查中发现	jian cha zhong fa xian	1339
坚持安全第一预防为主的方针	jian chi an quan di yi yu fang wei zhu de fang zhen	1509
坚持原则	jian chi yuan ze	1033
监督检查	jian du jian cha	1048
监督检查不得影响被检查单位的正常生产经营活动	jian du jian cha bu de ying xiang bei jian cha dan wei de zheng chang sheng chan jing ying huo dong	1049
监督教育	jian du jiao yu	1348
监督教育从业人员按照使用规则佩戴使用	jian du jiao yu cong ye ren yuan an zhao shi yong gui ze pei dai shi yong	1349
监督执法证件	jian du zhi fa zheng jian	1026
检举控告	jian ju kong gao	1245
建立健全安全生产责任制度	jian li jian quan an quan sheng chan ze ren zhi du	1507
建立举报制度	jian li ju bao zhi du	974
建立应急救援体系	jian li ying ji jiu yuan ti xi	925
建立专门的安全管理制度	jian li zhuan men de an quan guan li zhi du	1392
减少财产损失	jian shao cai chan sun shi	376
减少人员伤亡	jian shao ren yuan shang wang	893
建设项目	jian she xiang mu	1425
检验	jian yan	983
检验合格	jian yan he ge	660
降低	jiang di	1237
降低其工资福利待遇	jiang di qi gong zi fu li dai yu	1223
奖励办法	jiang li ban fa	941
将情况记录在案	jiang qing kuang ji lu zai an	1008
较大事故	jiao da shi gu	485
较大事故逐级上报至省自治区直辖市人民政府安全生产监督管理部门	jiao da shi gu zhu ji shang bao zhi sheng zi zhi qu zhi xia shi ren min zheng fu an quan sheng chan jian du guan li bu men	410
较大危险因素的生产经营场所	jiao da wei xian yin su de sheng chan jing ying chang suo	683
缴纳保险费	jiao na bao xian fei	1276
教育和督促	jiao yu he du cu	1359
教育和督促从业人员严格执行本单位的安全生产规章制度和安全操作规程	jiao yu he du cu cong ye ren yuan yan ge zhi xing ben dan wei de an quan sheng chan gui zhang zhi du he an quan cao zuo gui cheng	1361
教育和培训	jiao yu he pei xun	1435
教育培训	jiao yu pei xun	713
解除劳动合同	jie chu lao dong he tong	1234
解除与其订立的劳动合同	jie chu yu qi ding li de lao dong he tong	1222
接到报告	jie dao bao gao	1192
接到报告的人员应当及时予以处理	jie dao bao gao de ren yuan ying dang ji shi yu yi chu li	1193
接到举报的部门应当依法及时处理	jie dao ju bao de bu men ying dang yi fa ji shi chu li	435
接到举报后不予取缔	jie dao ju bao hou bu yu qu di	797
接到事故报告	jie dao shi gu bao gao	898
接到重大生产安全事故报告后	jie dao zhong da sheng chan an quan shi gu bao gao hou	873
借机打击报复	jie ji da ji bao fu	35
接受安全生产教育和培训掌握本职工作所需的安全生产知识	jie shou an quan sheng chan jiao yu he pei xun zhang wo ben zhi gong zuo suo xu de an quan sheng chan zhi shi	1206
接受安全生产教育培训	jie shou an quan sheng chan jiao yu pei xun	1205
接受工会和职工的监督	jie shou gong hui he zhi gong de jian du	138
接受审查验收	jie shou shen cha yan shou	1109
接受移送	jie shou yi song	994
接受移送的部门应当及时进行处理	jie shou yi song de bu men ying dang ji shi jin xing chu li	995
接受有关主管部门依法实施的监督管理	jie shou you guan zhu guan bu men yi fa shi shi de jian du guan li	1390
紧急情况	jin ji qing kuang	1231
紧急情况下	jin ji qing kuang xia	1225
进入生产经营单位	jin ru sheng chan jing ying dan wei	1095
进入生产经营单位进行检查调阅有关资料向有关单位和人员了解情况	jin ru sheng chan jing ying dan wei jin xing jian cha diao yue you guan zi liao xiang you guan dan wei he ren yuan liao jie qing kuang	1096
进行爆破吊装等危险作业	jin xing bao po diao zhuang deng wei xian zuo ye	1371
进行爆破吊装等危险作业未安排专门管理人员进行现场安全管理的	jin xing bao po diao zhuang deng wei xian zuo ye wei an pai zhuan men guan li ren yuan jin xing xian chang an quan guan li de	630
进行处分	jin xing chu fen	154
进行调查	jin xing diao cha	326
进行技术鉴定	jin xing ji shu jian ding	236
进行检查	jin xing jian cha	1094
进行监督	jin xing jian du	1185
进行监督检查	jin xing jian du jian cha	1098
进行经常性检查	jin xing jing chang xing jian cha	1341
进行评估监控	jin xing ping gu jian kong	633
进行审查验收	jin xing shen cha yan shou	1115
进行审查验收不得收取费用	jin xing shen cha yan shou bu de shou qu fei yong	1116
进行现场安全管理	jin xing xian chang an quan guan li	1366
进行行政处罚	jin xing xing zheng chu fa	156
进行严格检查	jin xing yan ge jian cha	1156
进行舆论监督	jin xing yu lun jian du	935
禁止封闭堵塞生产经营场所或者员工宿舍的出口	jin zhi feng bi du se sheng chan jing ying chang suo huo zhe yuan gong su she de chu kou	1375
禁止使用	jin zhi shi yong	653
经常性维护保养	jing chang xing wei hu bao yang	909
经调查核实后	jing diao cha he shi hou	965
经调查确定为责任事故的	jing diao cha que ding wei ze ren shi gu de	839
经负责事故调查的人民政府批准	jing fu ze shi gu diao cha de ren min zheng fu pi zhun	213
精简	jing jian	286
经批复的处理意见	jing pi fu de chu li yi jian	29
经人民法院依法采取执行措施后	jing ren min fa yuan yi fa cai qu zhi xing cuo shi hou	542
经审查同意	jing shen cha tong yi	1061
经停产停业整顿仍不具备安全生产条件的予以关闭	jing ting chan ting ye zheng dun reng bu ju bei an quan sheng chan tiao jian de yu yi guan bi	566
经专门的安全作业培训	jing zhuan men de an quan zuo ye pei xun	707
救援情况	jiu yuan qing kuang	197
举报	ju bao	331
举报安全生产违法行为	ju bao an quan sheng chan wei fa xing wei	944
举报电话	ju bao dian hua	971
举报电子邮件地址	ju bao dian zi you jian di zhi	969
举报信箱	ju bao xin xiang	970
举报制度	ju bao zhi du	973
具备国家规定的资质条件	ju bei guo jia gui ding de zi zhi tiao jian	978
拒不承担	ju bu cheng dan	549
拒不承担或者其负责人逃匿的由人民法院依法强制执行	ju bu cheng dan huo zhe qi fu ze ren tao ni de you ren min fa yuan yi fa qiang zhi zhi xing	550
拒绝接受调查	ju jue jie shou diao cha	92
拒绝接受调查或者拒绝提供有关情况和资料的	ju jue jie shou diao cha huo zhe ju jue ti gong you guan qing kuang he zi liao de	93
拒绝落实	ju jue luo shi	30
拒绝签字	ju jue qian zi	1009
拒绝提供有关情况和资料	ju jue ti gong you guan qing kuang he zi liao	91
拒绝违章指挥强令冒险作业而降低其工资福利等待遇或者解除与其订立的劳动合同	ju jue wei zhang zhi hui qiang ling mao xian zuo ye er jiang di qi gong zi fu li deng dai yu huo zhe jie chu yu qi ding li de lao dong he tong	1238
拘留	ju liu	574
居民委员会	ju min wei yuan hui	953
具体办法	ju ti ban fa	842
具体奖励办法由国务院负责安全生产监督管理的部门会同国务院财政部门制定	ju ti jiang li ban fa you guo wu yuan fu ze an quan sheng chan jian du guan li de bu men hui tong guo wu yuan cai zheng bu men zhi ding	942
具体情况	ju ti qing kuang	282
具有国家规定资质的单位	ju you guo jia gui ding zi zhi de dan wei	237
决策机构	jue ce ji gou	1454
决定机关	jue ding ji guan	22
竣工投入生产	jun gong tou ru sheng chan	689
均有权向负有安全生产监督管理职责的部门报告或者举报	jun you quan xiang fu you an quan sheng chan jian du guan li zhi ze de bu men bao gao huo zhe ju bao	955
考核合格	kao he he ge	1436
恪尽职守	ke jin zhi shou	227
可能危及对方安全生产	ke neng wei ji dui fang an quan sheng chan	610
可能危及对方生产安全的	ke neng wei ji dui fang sheng chan an quan de	1317
可以并处	ke yi bing chu	718
可以并处二万元以上十万元以下的罚款	ke yi bing chu er wan yuan yi shang shi wan yuan yi xia de fa kuan	640
可以并处二万元以下的罚款	ke yi bing chu er wan yuan yi xia de fa kuan	719
可以并处五万元以下的罚款	ke yi bing chu wu wan yuan yi xia de fa kuan	704
可以不建立应急救援组织的应当指定兼职的应急救援人员	ke yi bu jian li ying ji jiu yuan zu zhi de ying dang zhi ding jian zhi de ying ji jiu yuan ren yuan	917
可以会同	ke yi hui tong	477
可以适当延长	ke yi shi dang yan chang	209
可以直接组织事故调查组进行调查	ke yi zhi jie zu zhi shi gu diao cha zu jin xing diao cha	318
扣押	kou ya	1052
矿山和建筑施工单位	kuang shan he jian zhu shi gong dan wei	1447
矿山建设项目	kuang shan jian she xiang mu	701
矿山建设项目或者用于生产储存危险物品的建设项目	kuang shan jian she xiang mu huo zhe yong yu sheng chan chu cun wei xian wu pin de jian she xiang mu	702
矿山建设项目或者用于生产储存危险物品的建设项目的施工单位	kuang shan jian she xiang mu huo zhe yong yu sheng chan chu cun wei xian wu pin de jian she xiang mu de shi gong dan wei	693
矿山建设项目或者用于生产储存危险物品的建设项目竣工投入生产或者使用前	kuang shan jian she xiang mu huo zhe yong yu sheng chan chu cun wei xian wu pin de jian she xiang mu jun gong tou ru sheng chan huo zhe shi yong qian	690
矿山建筑施工单位	kuang shan jian zhu shi gong dan wei	921
劳动安全	lao dong an quan	1268
劳动保障行政部门	lao dong bao zhang xing zheng bu men	415
劳动防护用品	lao dong fang hu yong pin	1350
劳动合同	lao dong he tong	1272
立案侦查	li an zhen cha	344
立即处理	li ji chu li	1336
立即赶到事故现场	li ji gan dao shi gu xian chang	870
立即赶赴事故现场	li ji gan fu shi gu xian chang	373
立即如实报告	li ji ru shi bao gao	889
立即组织抢救	li ji zu zhi qiang jiu	579
立即作出处理	li ji zuo chu chu li	1168
连带赔偿责任	lian dai pei chang ze ren	756
联合检查	lian he jian cha	1003
两个以上生产经营单位	liang ge yi shang sheng chan jing ying dan wei	1318
两个以上生产经营单位在同一作业区域内进行生产经营活动	liang ge yi shang sheng chan jing ying dan wei zai tong yi zuo ye qu yu nei jin xing sheng chan jing ying huo dong	1320
了解情况	liao jie qing kuang	1091
另行组织	ling xing zu zhi	294
另有规定	ling you gui ding	21
漏报	lou bao	462
落实防范措施	luo shi fang fan cuo shi	143
落实防范和整改措施	luo shi fang fan he zheng gai cuo shi	147
落实情况	luo shi qing kuang	139
落实生产安全事故责任追究制度	luo shi sheng chan an quan shi gu ze ren zhui jiu zhi du	508
落实整改措施	luo shi zheng gai cuo shi	959
履行安全生产监督管理职责	lv xing an quan sheng chan jian du guan li zhi ze	989
瞒报	man bao	461
冒险作业	mao xian zuo ye	1240
每级上报的时间不得超过二小时	mei ji shang bao de shi jian bu de chao guo er xiao shi	397
没有安全设施设计或者安全设施设计未按照规定报经有关部门审查同意的	mei you an quan she shi she ji huo zhe an quan she shi she ji wei an zhao gui ding bao jing you guan bu men shen cha tong yi de	699
没有违法所得或者违法所得不足十万元的	mei you wei fa suo de huo zhe wei fa suo de bu zu shi wan yuan de	643
没有违法所得或者违法所得不足五千元的	mei you wei fa suo de huo zhe wei fa suo de bu zu wu qian yuan de	762
没有造成人员伤亡	mei you zao cheng ren yuan shang wang	20
免除或者减轻	mian chu huo zhe jian qing	1257
免除或者减轻其对从业人员因生产安全事故伤亡依法应承担的责任	mian chu huo zhe jian qing qi dui cong ye ren yuan yin sheng chan an quan shi gu shang wang yi fa ying cheng dan de ze ren	1258
免除或者减轻其对从业人员因生产安全事故伤亡依法应承担的责任的该协议无效	mian chu huo zhe jian qing qi dui cong ye ren yuan yin sheng chan an quan shi gu shang wang yi fa ying cheng dan de ze ren de gai xie yi wu xiao	595
免除减轻	mian chu jian qing	594
民用航空安全	min yong hang kong an quan	1511
明确各自的安全生产管理职责	ming que ge zi de an quan sheng chan guan li zhi ze	614
明确各自的安全生产管理职责和应当采取的安全措施	ming que ge zi de an quan sheng chan guan li zhi ze he ying dang cai qu de an quan cuo shi	1314
没收违法所得	mo shou wei fa suo de	766
纳入建设项目概算	na ru jian she xiang mu gai suan	1420
能够危及人身安全	neng gou wei ji ren shen an quan	524
能够危及人身安全和财产安全的物品	neng gou wei ji ren shen an quan he cai chan an quan de wu pin	525
年收入	nian shou ru	121
排除过程中	pai chu guo cheng zhong	1073
排除前	pai chu qian	1074
派人组成	pai ren zu cheng	279
配备专职安全生产管理人员	pei bei zhuan zhi an quan sheng chan guan li ren yuan	1444
赔偿要求	pei chang yao qiu	1213
赔偿义务	pei chang yi wu	534
赔偿责任	pei chang ze ren	755
佩戴使用	pei dai shi yong	1346
批复时间	pi fu shi jian	166
批评教育	pi ping jiao yu	587
批准	pi zhun	1146
批准后执行	pi zhun hou zhi xing	1396
聘请专家	pin qing zhuan jia	275
评估监控	ping gu jian kong	632
评价	ping jia	985
器材	qi cai	1054
其负责人应当立即赶赴事故现场	qi fu ze ren ying dang li ji gan fu shi gu xian chang	375
其他不安全因素	qi ta bu an quan yin su	1196
其他财产	qi ta cai chan	532
其他产品	qi ta chan pin	1104
其他应当报告的情况	qi ta ying dang bao gao de qing kuang	384
其他有关法律行政法规的规定	qi ta you guan fa lv xing zheng fa gui de gui ding	1081
其他直接责任人员	qi ta zhi jie ze ren ren yuan	776
签订专门的安全生产管理协议	qian ding zhuan men de an quan sheng chan guan li xie yi	1294
签名	qian ming	184
抢救人员	qiang jiu ren yuan	352
强令冒险作业	qiang ling mao xian zuo ye	1241
抢险救护	qiang xian jiu hu	1472
强制措施	qiang zhi cuo shi	342
强制执行	qiang zhi zhi xing	545
且危险物品的数量等于或者超过临界量的单元	qie wei xian wu pin de shu liang deng yu huo zhe chao guo lin jie liang de dan yuan	521
侵犯从业人员合法权益行为	qin fan cong ye ren yuan he fa quan yi xing wei	1181
情节严重	qing jie yan zhong	778
情节严重的对直接负责的主管人员和其他直接责任人员依法给予行政处分	qing jie yan zhong de dui zhi jie fu ze de zhu guan ren yuan he qi ta zhi jie ze ren ren yuan yi fa gei yu xing zheng chu fen	779
情况紧急	qing kuang jin ji	423
情况紧急时	qing kuang jin ji shi	424
取得安全使用证或者安全标志	qu de an quan shi yong zheng huo zhe an quan biao zhi	1399
取得安全使用证或者安全标志投入使用的	qu de an quan shi yong zheng huo zhe an quan biao zhi tou ru shi yong de	659
取得特种作业操作资格证书上岗作业的	qu de te zhong zuo ye cao zuo zi ge zheng shu shang gang zuo ye de	710
取得显著成绩	qu de xian zhu cheng ji	1471
权利和义务	quan li he yi wu	1527
权限	quan xian	558
确保安全生产	que bao an quan sheng chan	1505
确保操作规程的遵守	que bao cao zuo gui cheng de zun shou	1364
确需分别进行检查的应当互通情况	que xu fen bie jin xing jian cha de ying dang hu tong qing kuang	1002
认定事故的性质和事故责任	ren ding shi gu de xing zhi he shi gu ze ren	260
认定事故责任	ren ding shi gu ze ren	455
任何单位和个人不得破坏事故现场毁灭相关证据	ren he dan wei he ge ren bu de po huai shi gu xian chang hui mie xiang guan zheng ju	370
任何单位和个人不得阻挠和干涉对事故的报告和依法调查处理	ren he dan wei he ge ren bu de zu nao he gan she dui shi gu de bao gao he yi fa diao cha chu li	438
任何单位和个人不得阻挠和干涉对事故的依法调查处理	ren he dan wei he ge ren bu de zu nao he gan she dui shi gu de yi fa diao cha chu li	824
任何单位和个人都应当支持配合事故抢救并提供一切便利条件	ren he dan wei he ge ren dou ying dang zhi chi pei he shi gu qiang jiu bing ti gong yi qie bian li tiao jian	867
任何单位和个人对事故不得迟报漏报谎报或者瞒报	ren he dan wei he ge ren dui shi gu bu de chi bao lou bao huang bao huo zhe man bao	464
任何单位和个人有权向安监部门监察机关或者其他有关部门举报	ren he dan wei he ge ren you quan xiang an jian bu men jian cha ji guan huo zhe qi ta you guan bu men ju bao	436
任何单位或者个人对事故隐患或者安全生产违法行为	ren he dan wei huo zhe ge ren dui shi gu yin huan huo zhe an quan sheng chan wei fa xing wei	956
任何形式	ren he xing shi	1260
人民法院	ren min fa yuan	547
人民检察院	ren min jian cha yuan	413
人民团体	ren min tuan ti	10
人民政府	ren min zheng fu	171
认为必要时	ren wei bi yao shi	309
人员伤亡	ren yuan shang wang	551
认真吸取	ren zhen xi qu	144
认证	ren zheng	1140
仍不具备安全生产条件	reng bu ju bei an quan sheng chan tiao jian	565
仍不能对受害人给予足额赔偿的应当继续履行赔偿义务	reng bu neng dui shou hai ren gei yu zu e pei chang de ying dang ji xu lv xing pei chang yi wu	540
容易发生重大生产安全事故	rong yi fa sheng zhong da sheng chan an quan shi gu	1157
如实告知	ru shi gao zhi	1357
如实提供	ru shi ti gong	248
如实提供有关情况	ru shi ti gong you guan qing kuang	250
三同时	san tong shi	1422
擅离职守	shan li zhi shou	1280
擅自从事	shan zi cong shi	1129
擅自从事有关活动	shan zi cong shi you guan huo dong	798
擅自从事有关活动或者接到举报后不予取缔或者不依法予以处理的	shan zi cong shi you guan huo dong huo zhe jie dao ju bao hou bu yu qu di huo zhe bu yi fa yu yi chu li de	799
擅自生产经营储存危险物品	shan zi sheng chan jing ying chu cun wei xian wu pin	648
上报事故情况	shang bao shi gu qing kuang	877
尚不够刑事处罚	shang bu gou xing shi chu fa	729
尚不够刑事处罚的	shang bu gou xing shi chu fa de	736
尚不够刑事处罚的给予撤职处分或者处二万元以上二十万元以下的罚款	shang bu gou xing shi chu fa de gei yu che zhi chu fen huo zhe chu er wan yuan yi shang er shi wan yuan yi xia de fa kuan	730
尚不够刑事处罚的没收违法所得	shang bu gou xing shi chu fa de mo shou wei fa suo de	764
上岗作业	shang gang zuo ye	1433
上级机关	shang ji ji guan	784
上级人民政府可以另行组织事故调查组进行调查	shang ji ren min zheng fu ke yi ling xing zu zhi shi gu diao cha zu jin xing diao cha	301
上级人民政府认为必要时可以调查由下级人民政府负责调查的事故	shang ji ren min zheng fu ren wei bi yao shi ke yi diao cha you xia ji ren min zheng fu fu ze diao cha de shi gu	310
伤亡人数	shang wang ren shu	388
上一年年收入百分之四十至百分之八十的罚款	shang yi nian nian shou ru bai fen zhi si shi zhi bai fen zhi ba shi de fa kuan	122
尚有获得赔偿的权利	shang you huo de pei chang de quan li	1216
设备	she bei	1306
设备发包出租	she bei fa bao chu zu	626
设备发包或者出租给不具备安全生产条件	she bei fa bao huo zhe chu zu gei bu ju bei an quan sheng chan tiao jian	627
社会影响恶劣	she hui ying xiang e lie	19
涉及安全生产的事项	she ji an quan sheng chan de shi xiang	1148
涉及被检查单位的技术秘密业务秘密	she ji bei jian cha dan wei de ji shu mi mi ye wu mi mi	1023
设计单位	she ji dan wei	1416
设计人	she ji ren	1417
涉及生命安全危险性较大的特种设备	she ji sheng ming an quan wei xian xing jiao da de te zhong she bei	1404
设区的市级人民政府	she qu de shi ji ren min zheng fu	320
设施	she shi	1055
设施设备器材予以查封或者扣押	she shi she bei qi cai yu yi cha feng huo zhe kou ya	1058
涉嫌犯罪	she xian fan zui	346
设有符合紧急疏散需要	she you fu he jin ji shu san xu yao	599
设置明显	she zhi ming xian	1408
审查	shen cha	1147
审查同意	shen cha tong yi	694
审查验收	shen cha yan shou	1114
审查验收中收取费用	shen cha yan shou zhong shou qu fei yong	786
生产安全事故	sheng chan an quan shi gu	1520
生产安全事故报告和调查处理条例	sheng chan an quan shi gu bao gao he diao cha chu li tiao li	517
生产安全事故的报告和调查处理适用本条例	sheng chan an quan shi gu de bao gao he diao cha chu li shi yong ben tiao li	503
生产安全事故的应急救援	sheng chan an quan shi gu de ying ji jiu yuan	932
生产安全事故的应急救援与调查处理	sheng chan an quan shi gu de ying ji jiu yuan yu diao cha chu li	933
生产安全事故的责任人	sheng chan an quan shi gu de ze ren ren	543
生产安全事故的责任人未依法承担赔偿责任	sheng chan an quan shi gu de ze ren ren wei yi fa cheng dan pei chang ze ren	544
生产安全事故伤亡	sheng chan an quan shi gu shang wang	1256
生产安全事故应急救援	sheng chan an quan shi gu ying ji jiu yuan	1525
生产安全事故应急救援预案	sheng chan an quan shi gu ying ji jiu yuan yu an	1457
生产安全事故应急救援与调查处理	sheng chan an quan shi gu ying ji jiu yuan yu diao cha chu li	1524
生产安全事故责任追究制度	sheng chan an quan shi gu ze ren zhui jiu zhi du	1479
生产储存危险物品	sheng chan chu cun wei xian wu pin	1415
生产经营	sheng chan jing ying	1309
生产经营场所	sheng chan jing ying chang suo	1380
生产经营场所出口	sheng chan jing ying chang suo chu kou	1373
生产经营场所和员工宿舍未设有符合紧急疏散需要标志明显保持畅通的出口	sheng chan jing ying chang suo he yuan gong su she wei she you fu he jin ji shu san xu yao biao zhi ming xian bao chi chang tong de chu kou	600
生产经营储存单位	sheng chan jing ying chu cun dan wei	922
生产经营储存使用危险物品	sheng chan jing ying chu cun shi yong wei xian wu pin	639
生产经营储存使用危险物品的车间商店仓库不得与员工宿舍在同一座建筑物内	sheng chan jing ying chu cun shi yong wei xian wu pin de che jian shang dian cang ku bu de yu yuan gong su she zai tong yi zuo jian zhu wu nei	1384
生产经营储存使用危险物品的车间商店仓库与员工宿舍在同一座建筑内	sheng chan jing ying chu cun shi yong wei xian wu pin de che jian shang dian cang ku yu yuan gong su she zai tong yi zuo jian zhu nei	606
生产经营单位	sheng chan jing ying dan wei	1530
生产经营单位必须对安全设备进行经常性维护保养并定期检测保证正常运转	sheng chan jing ying dan wei bi xu dui an quan she bei jin xing jing chang xing wei hu bao yang bing ding qi jian ce bao zheng zheng chang yun zhuan	1406
生产经营单位必须立即作出处理	sheng chan jing ying dan wei bi xu li ji zuo chu chu li	1169
生产经营单位必须执行依法制定的保障安全生产的国家标准或者行业标准	sheng chan jing ying dan wei bi xu zhi xing yi fa zhi ding de bao zhang an quan sheng chan de guo jia biao zhun huo zhe hang ye biao zhun	1487
生产经营单位不得使用国家明令淘汰禁止使用的危及生产安全的工艺设备	sheng chan jing ying dan wei bu de shi yong guo jia ming ling tao tai jin zhi shi yong de wei ji sheng chan an quan de gong yi she bei	1394
生产经营单位不具备本法和其他有关法律行政法规	sheng chan jing ying dan wei bu ju bei ben fa he qi ta you guan fa lv xing zheng fa gui	568
生产经营单位的从业人员不服从管理	sheng chan jing ying dan wei de cong ye ren yuan bu fu cong guan li	590
生产经营单位的从业人员有依法获得安全生产保障的权利	sheng chan jing ying dan wei de cong ye ren yuan you yi fa huo de an quan sheng chan bao zhang de quan li	1503
生产经营单位的决策机构	sheng chan jing ying dan wei de jue ce ji gou	752
生产经营单位的主要负责人对本单位的安全生产工作全面负责	sheng chan jing ying dan wei de zhu yao fu ze ren dui ben dan wei de an quan sheng chan gong zuo quan mian fu ze	1504
生产经营单位的主要负责人未履行本法规定的安全生产管理职责的	sheng chan jing ying dan wei de zhu yao fu ze ren wei lv xing ben fa gui ding de an quan sheng chan guan li zhi ze de	733
生产经营单位的主要负责人依照前款规定受刑事处罚或者撤职处分的	sheng chan jing ying dan wei de zhu yao fu ze ren yi zhao qian kuan gui ding shou xing shi chu fa huo zhe che zhi chu fen de	727
生产经营单位的主要负责人有前款违法行为	sheng chan jing ying dan wei de zhu yao fu ze ren you qian kuan wei fa xing wei	732
生产经营单位对承包单位承租单位的安全生产工作统一协调管理	sheng chan jing ying dan wei dui cheng bao dan wei cheng zu dan wei de an quan sheng chan gong zuo tong yi xie tiao guan li	1288
生产经营单位对负有安全生产监督管理职责的部门的监督检查人员	sheng chan jing ying dan wei dui fu you an quan sheng chan jian du guan li zhi ze de bu men de jian du jian cha ren yuan	1044
生产经营单位发生生产安全事故	sheng chan jing ying dan wei fa sheng sheng chan an quan shi gu	840
生产经营单位发生生产安全事故后	sheng chan jing ying dan wei fa sheng sheng chan an quan shi gu hou	905
生产经营单位发生生产安全事故造成人员伤亡	sheng chan jing ying dan wei fa sheng sheng chan an quan shi gu zao cheng ren yuan shang wang	554
生产经营单位将生产经营项目场所	sheng chan jing ying dan wei jiang sheng chan jing ying xiang mu chang suo	629
生产经营单位未与承包单位承租单位	sheng chan jing ying dan wei wei yu cheng bao dan wei cheng zu dan wei	617
生产经营单位应当及时研究答复	sheng chan jing ying dan wei ying dang ji shi yan jiu da fu	1175
生产经营单位应当在有较大危险因素的生产经营场所和有关设施设备上设置明显的安全警示标志	sheng chan jing ying dan wei ying dang zai you jiao da wei xian yin su de sheng chan jing ying chang suo he you guan she shi she bei shang she zhi ming xian de an quan jing shi biao zhi	1410
生产经营单位有下列行为之一的责令限期改正	sheng chan jing ying dan wei you xia lie xing wei zhi yi de ze ling xian qi gai zheng	723
生产经营单位有下列行为之一的责令限期改正逾期未改正的责令停产停业整顿	sheng chan jing ying dan wei you xia lie xing wei zhi yi de ze ling xian qi gai zheng yu qi wei gai zheng de ze ling ting chan ting ye zheng dun	607
生产经营单位与从业人员订立的劳动合同	sheng chan jing ying dan wei yu cong ye ren yuan ding li de lao dong he tong	1274
生产经营单位与从业人员订立协议	sheng chan jing ying dan wei yu cong ye ren yuan ding li xie yi	596
生产经营单位主要负责人	sheng chan jing ying dan wei zhu yao fu ze ren	573
生产经营单位主要负责人在本单位发生重大生产安全事故时	sheng chan jing ying dan wei zhu yao fu ze ren zai ben dan wei fa sheng zhong da sheng chan an quan shi gu shi	581
生产经营规模较小	sheng chan jing ying gui mo jiao xiao	919
生产经营活动中发生的	sheng chan jing ying huo dong zhong fa sheng de	505
生产经营特点	sheng chan jing ying te dian	1344
生产经营项目场所	sheng chan jing ying xiang mu chang suo	628
生产经营项目场所有多个承包单位承租单位	sheng chan jing ying xiang mu chang suo you duo ge cheng bao dan wei cheng zu dan wei	1299
省级人民政府	sheng ji ren min zheng fu	321
省级人民政府接到发生特别重大事故重大事故的报告后	sheng ji ren min zheng fu jie dao fa sheng te bie zhong da shi gu zhong da shi gu de bao gao hou	404
省级人民政府设区的市级人民政府县级人民政府负责调查	sheng ji ren min zheng fu she qu de shi ji ren min zheng fu xian ji ren min zheng fu fu ze diao cha	323
适当延长	shi dang yan chang	208
施工单位	shi gong dan wei	692
事故报告	shi gu bao gao	434
事故报告后出现新情况的应当及时补报	shi gu bao gao hou chu xian xin qing kuang de ying dang ji shi bu bao	383
事故报告应当及时准确完整	shi gu bao gao ying dang ji shi zhun que wan zheng	468
事故处理	shi gu chu li	173
事故处理的情况	shi gu chu li de qing kuang	132
事故处理的情况由负责事故调查的人民政府	shi gu chu li de qing kuang you fu ze shi gu diao cha de ren min zheng fu	135
事故的简要经过	shi gu de jian yao jing guo	391
事故等级	shi gu deng ji	298
事故调查	shi gu diao cha	1166
事故调查报告	shi gu diao cha bao gao	256
事故调查报告报送	shi gu diao cha bao gao bao song	180
事故调查报告报送负责事故调查的人民政府后	shi gu diao cha bao gao bao song fu ze shi gu diao cha de ren min zheng fu hou	183
事故调查报告应当包括下列内容	shi gu diao cha bao gao ying dang bao kuo xia lie nei rong	205
事故调查报告应当附具有关证据材料	shi gu diao cha bao gao ying dang fu ju you guan zheng ju cai liao	190
事故调查处理	shi gu diao cha chu li	863
事故调查处理工作	shi gu diao cha chu li gong zuo	445
事故调查处理期间	shi gu diao cha chu li qi jian	578
事故调查处理应当按照实事求是尊重科学的原则	shi gu diao cha chu li ying dang an zhao shi shi qiu shi zun zhong ke xue de yuan ze	864
事故调查处理应当坚持实事求是尊重科学的原则	shi gu diao cha chu li ying dang jian chi shi shi qiu shi zun zhong ke xue de yuan ze	460
事故调查的有关资料	shi gu diao cha de you guan zi liao	176
事故调查的有关资料应当归档保存	shi gu diao cha de you guan zi liao ying dang gui dang bao cun	181
事故调查工作即告结束	shi gu diao cha gong zuo ji gao jie shu	182
事故调查工作有重大疏漏	shi gu diao cha gong zuo you zhong da shu lou	39
事故调查和处理	shi gu diao cha he chu li	843
事故调查和处理的具体办法由国务院制定	shi gu diao cha he chu li de ju ti ban fa you guo wu yuan zhi ding	844
事故调查期限	shi gu diao cha qi xian	230
事故调查中发现涉嫌犯罪的	shi gu diao cha zhong fa xian she xian fan zui de	246
事故调查中需要进行技术鉴定的	shi gu diao cha zhong xu yao jin xing ji shu jian ding de	241
事故调查组	shi gu diao cha zu	316
事故调查组成员	shi gu diao cha zu cheng yuan	268
事故调查组成员不得擅自发布有关事故的信息	shi gu diao cha zu cheng yuan bu de shan zi fa bu you guan shi gu de xin xi	221
事故调查组成员应当具有事故调查所需要的知识和专长	shi gu diao cha zu cheng yuan ying dang ju you shi gu diao cha suo xu yao de zhi shi he zhuan chang	273
事故调查组成员应当在事故调查报告上签名	shi gu diao cha zu cheng yuan ying dang zai shi gu diao cha bao gao shang qian ming	185
事故调查组成员在事故调查工作中应当诚信公正恪尽职守	shi gu diao cha zu cheng yuan zai shi gu diao cha gong zuo zhong ying dang cheng xin gong zheng ke jin zhi shou	229
事故调查组的组成应当遵循精简效能的原则	shi gu diao cha zu de zu cheng ying dang zun xun jing jian xiao neng de yuan ze	288
事故调查组可以聘请有关专家参与调查	shi gu diao cha zu ke yi pin qing you guan zhuan jia can yu diao cha	276
事故调查组可以直接组织专家进行技术鉴定	shi gu diao cha zu ke yi zhi jie zu zhi zhuan jia jin xing ji shu jian ding	235
事故调查组履行下列职责	shi gu diao cha zu lv xing xia lie zhi ze	262
事故调查组应当及时将有关材料或者其复印件移交司法机关处理	shi gu diao cha zu ying dang ji shi jiang you guan cai liao huo zhe qi fu yin jian yi jiao si fa ji guan chu li	245
事故调查组应当委托具有国家规定资质的单位进行技术鉴定	shi gu diao cha zu ying dang wei tuo ju you guo jia gui ding zi zhi de dan wei jin xing ji shu jian ding	240
事故调查组应当自事故发生之日起六十日内提交事故调查报告	shi gu diao cha zu ying dang zi shi gu fa sheng zhi ri qi liu shi ri nei ti jiao shi gu diao cha bao gao	217
事故调查组有权向有关单位和个人了解与事故有关的情况	shi gu diao cha zu you quan xiang you guan dan wei he ge ren liao jie yu shi gu you guan de qing kuang	255
事故调查组由有关人民政府安监部门负有安监职责的有关部门	shi gu diao cha zu you you guan ren min zheng fu an jian bu men fu you an jian zhi ze de you guan bu men	281
事故调查组组长	shi gu diao cha zu zu zhang	265
事故调查组组长由负责事故调查的人民政府指定	shi gu diao cha zu zu zhang you fu ze shi gu diao cha de ren min zheng fu zhi ding	267
事故调查组组长主持事故调查组的工作	shi gu diao cha zu zu zhang zhu chi shi gu diao cha zu de gong zuo	266
事故发生单位	shi gu fa sheng dan wei	311
事故发生单位的负责人和有关人员在事故调查期间不得擅离职守	shi gu fa sheng dan wei de fu ze ren he you guan ren yuan zai shi gu diao cha qi jian bu de shan li zhi shou	252
事故发生单位对事故发生负有责任的依照下列规定处以罚款	shi gu fa sheng dan wei dui shi gu fa sheng fu you ze ren de yi zhao xia lie gui ding chu yi fa kuan	86
事故发生单位对事故发生负有责任的由有关部门	shi gu fa sheng dan wei dui shi gu fa sheng fu you ze ren de you you guan bu men	69
事故发生单位负责人接到事故报告后应当立即启动事故相应应急预案	shi gu fa sheng dan wei fu ze ren jie dao shi gu bao gao hou ying dang li ji qi dong shi gu xiang ying ying ji yu an	378
事故发生单位概况	shi gu fa sheng dan wei gai kuang	393
事故发生单位及其有关人员有下列行为之一的	shi gu fa sheng dan wei ji qi you guan ren yuan you xia lie xing wei zhi yi de	114
事故发生单位所在地人民政府应当派人参加	shi gu fa sheng dan wei suo zai di ren min zheng fu ying dang pai ren can jia	289
事故发生单位应当按照负责事故调查的人民政府的批复	shi gu fa sheng dan wei ying dang an zhao fu ze shi gu diao cha de ren min zheng fu de pi fu	153
事故发生单位应当认真吸取事故教训	shi gu fa sheng dan wei ying dang ren zhen xi qu shi gu jiao xun	148
事故发生单位主要负责人	shi gu fa sheng dan wei zhu yao fu ze ren	81
事故发生单位主要负责人受到刑事处罚或者撤职处分的	shi gu fa sheng dan wei zhu yao fu ze ren shou dao xing shi chu fa huo zhe che zhi chu fen de	65
事故发生单位主要负责人有下列行为之一的	shi gu fa sheng dan wei zhu yao fu ze ren you xia lie xing wei zhi yi de	126
事故发生的时间地点以及事故现场情况	shi gu fa sheng de shi jian de dian yi ji shi gu xian chang qing kuang	392
事故发生的原因和事故性质	shi gu fa sheng de yuan yin he shi gu xing zhi	202
事故发生地	shi gu fa sheng di	428
事故发生地公安机关根据事故的情况	shi gu fa sheng di gong an ji guan gen ju shi gu de qing kuang	350
事故发生地有关地方人民政府	shi gu fa sheng di you guan di fang ren min zheng fu	448
事故发生地与事故发生单位不在同一个县级以上行政区域的	shi gu fa sheng di yu shi gu fa sheng dan wei bu zai tong yi ge xian ji yi shang xing zheng qu yu de	292
事故发生负有责任的关部门	shi gu fa sheng fu you ze ren de guan bu men	56
事故发生后	shi gu fa sheng hou	433
事故发生后逃匿的	shi gu fa sheng hou tao ni de	87
事故发生后有关单位和人员应当妥善保护事故现场以及相关证据	shi gu fa sheng hou you guan dan wei he ren yuan ying dang tuo shan bao hu shi gu xian chang yi ji xiang guan zheng ju	371
事故发生经过和事故救援情况	shi gu fa sheng jing guo he shi gu jiu yuan qing kuang	204
事故防范	shi gu fang fan	191
事故防范和整改措施	shi gu fang fan he zheng gai cuo shi	200
事故教训	shi gu jiao xun	850
事故经过	shi gu jing guo	458
事故救援	shi gu jiu yuan	372
事故抢救	shi gu qiang jiu	868
事故伤亡人数变化	shi gu shang wang ren shu bian hua	300
事故损失	shi gu sun shi	457
事故现场	shi gu xian chang	902
事故现场有关人员可以直接向事故发生地县级以上人民政府安监部门	shi gu xian chang you guan ren yuan ke yi zhi jie xiang shi gu fa sheng di xian ji yi shang ren min zheng fu an jian bu men	422
事故现场有关人员应当立即报告本单位负责人	shi gu xian chang you guan ren yuan ying dang li ji bao gao ben dan wei fu ze ren	903
事故现场有关人员应当立即向本单位负责人报告	shi gu xian chang you guan ren yuan ying dang li ji xiang ben dan wei fu ze ren bao gao	432
事故性质	shi gu xing zhi	853
事故一般分为	shi gu yi ban fen wei	496
事故已经造成或者可能造成的伤亡人数包括下落不明的人数	shi gu yi jing zao cheng huo zhe ke neng zao cheng de shang wang ren shu bao kuo xia luo bu ming de ren shu	390
事故隐患	shi gu yin huan	1458
事故应急措施	shi gu ying ji cuo shi	1353
事故原因	shi gu yuan yin	855
事故造成的人员伤亡和直接经济损失	shi gu zao cheng de ren yuan shang wang he zhi jie jing ji sun shi	203
事故造成的伤亡人数发生变化的应当及时补报	shi gu zao cheng de shang wang ren shu fa sheng bian hua de ying dang ji shi bu bao	380
事故责任	shi gu ze ren	852
事故责任的认定以及对事故责任者的处理建议	shi gu ze ren de ren ding yi ji dui shi gu ze ren zhe de chu li jian yi	201
事故责任认定	shi gu ze ren ren ding	194
事故责任者	shi gu ze ren zhe	846
十人以上五十人以下重伤	shi ren yi shang wu shi ren yi xia zhong shang	483
实施监察	shi shi jian cha	988
实事求是	shi shi qiu shi	860
实事求是尊重科学的原则	shi shi qiu shi zun zhong ke xue de yuan ze	861
实施综合监督管理	shi shi zong he jian du guan li	1496
事项	shi xiang	1262
实行联合检查	shi xing lian he jian cha	1004
事业单位	shi ye dan wei	11
使用	shi yong	678
使用国家明令淘汰禁止使用的危及生产安全的工艺设备的	shi yong guo jia ming ling tao tai jin zhi shi yong de wei ji sheng chan an quan de gong yi she bei de	655
使用前	shi yong qian	688
失职渎职	shi zhi du zhi	827
失职渎职行为	shi zhi du zhi xing wei	828
是指造成三人以上十人以下死亡	shi zhi zao cheng san ren yi shang shi ren yi xia si wang	484
是指造成三人以下死亡或者十人以下重伤	shi zhi zao cheng san ren yi xia si wang huo zhe shi ren yi xia zhong shang	480
是指造成三十人以上死亡或者一百人以上重伤	shi zhi zao cheng san shi ren yi shang si wang huo zhe yi bai ren yi shang zhong shang	493
是指造成十人以上三十人以下死亡	shi zhi zao cheng shi ren yi shang san shi ren yi xia si wang	488
受到刑事处罚	shou dao xing shi chu fa	47
受害人	shou hai ren	539
受害人发现责任人有其他财产的可以随时请求人民法院执行	shou hai ren fa xian ze ren ren you qi ta cai chan de ke yi sui shi qing qiu ren min fa yuan zhi xing	533
受理的举报事项经调查核实后应当形成书面材料	shou li de ju bao shi xiang jing diao cha he shi hou ying dang xing cheng shu mian cai liao	967
受理举报事项	shou li ju bao shi xiang	966
受理事故报告	shou li shi gu bao gao	332
受理事故报告和举报	shou li shi gu bao gao he ju bao	333
受理有关安全生产的举报	shou li you guan an quan sheng chan de ju bao	968
收取的费用	shou qu de fei yong	780
收取费用	shou qu fei yong	1112
授权	shou quan	328
授权的有关部门机构	shou quan de you guan bu men ji gou	130
授权有关部门	shou quan you guan bu men	329
书面材料	shu mian cai liao	961
书面记录	shu mian ji lu	1013
疏通交通	shu tong jiao tong	351
属于国家工作人员的并依法给予处分	shu yu guo jia gong zuo ren yuan de bing yi fa ji yu chu fen	123
水上交通安全	shui shang jiao tong an quan	1512
随时接受事故调查组的询问	sui shi jie shou shi gu diao cha zu de xun wen	249
随时请求人民法院执行	sui shi qing qiu ren min fa yuan zhi xing	531
所称的以下不包括本数	suo cheng de yi xia bu bao kuo ben shu	470
所需时间	suo xu shi jian	232
所在区域内	suo zai qu yu nei	950
他人财产损失的应当依法承担赔偿责任	ta ren cai chan sun shi de ying dang yi fa cheng dan pei chang ze ren	553
袒护	tan hu	36
逃匿	tao ni	577
特别重大事故	te bie zhong da shi gu	494
特别重大事故三十日内做出批复	te bie zhong da shi gu san shi ri nei zuo chu pi fu	168
特别重大事故以下等级事故	te bie zhong da shi gu yi xia deng ji shi gu	293
特别重大事故以下等级事故的报告和调查处理	te bie zhong da shi gu yi xia deng ji shi gu de bao gao he diao cha chu li	8
特别重大事故由国务院或者国务院授权有关部门组织事故调查组进行调查	te bie zhong da shi gu you guo wu yuan huo zhe guo wu yuan shou quan you guan bu men zu zhi shi gu diao cha zu jin xing diao cha	330
特别重大事故重大事故逐级上报至国务院安全生产监督管理部门	te bie zhong da shi gu zhong da shi gu zhu ji shang bao zhi guo wu yuan an quan sheng chan jian du guan li bu men	412
特大生产安全事故	te da sheng chan an quan shi gu	928
特大生产安全事故应急救援预案	te da sheng chan an quan shi gu ying ji jiu yuan yu an	929
特殊情况	te shu qing kuang	214
特殊情况下	te shu qing kuang xia	215
特殊情况下批复时间可以适当延长但延长的时间最长不超过三十日	te shu qing kuang xia pi fu shi jian ke yi shi dang yan chang dan yan chang de shi jian zui chang bu chao guo san shi ri	167
特种设备	te zhong she bei	668
特种设备以及危险物品的容器运输工具	te zhong she bei yi ji wei xian wu pin de rong qi yun shu gong ju	669
特种作业操作资格证书	te zhong zuo ye cao zuo zi ge zheng shu	1427
特种作业人员	te zhong zuo ye ren yuan	1429
特种作业人员未	te zhong zuo ye ren yuan wei	709
特种作业人员未按照规定经专门的安全作业培训	te zhong zuo ye ren yuan wei an zhao gui ding jing zhuan men de an quan zuo ye pei xun	711
提出处理意见	ti chu chu li yi jian	1165
提出对事故责任者的处理建议	ti chu dui shi gu ze ren zhe de chu li jian yi	259
提出防范和整改措施	ti chu fang fan he zheng gai cuo shi	258
提出建议	ti chu jian yi	1249
提出批评	ti chu pi ping	1246
提出意见	ti chu yi jian	1184
提出整改措施	ti chu zheng gai cuo shi	849
提高安全生产技能	ti gao an quan sheng chan ji neng	1202
提高安全生产技能增强事故预防和应急处理能力	ti gao an quan sheng chan ji neng zeng qiang shi gu yu fang he ying ji chu li neng li	1203
提高安全生产水平	ti gao an quan sheng chan shui ping	1475
提高工作效率	ti gao gong zuo xiao lv	440
提高职工的安全生产意识	ti gao zhi gong de an quan sheng chan yi shi	1484
提供必需的资金	ti gong bi xu de zi jin	743
提供技术服务	ti gong ji shu fu wu	1480
提供虚假证明	ti gong xu jia zheng ming	43
提供一切便利条件	ti gong yi qie bian li tiao jian	865
提交报告	ti jiao bao gao	216
提交报告期限	ti jiao bao gao qi xian	210
提交事故调查报告	ti jiao shi gu diao cha bao gao	257
提交事故调查报告的期限可以适当延长	ti jiao shi gu diao cha bao gao de qi xian ke yi shi dang yan chang	212
铁路交通安全	tie lu jiao tong an quan	1513
停产停业	ting chan ting ye	1065
停产停业整顿	ting chan ting ye zheng dun	739
停止使用	ting zhi shi yong	1064
停止作业	ting zhi zuo ye	1229
统称安全生产监督检查人员	tong cheng an quan sheng chan jian du jian cha ren yuan	1042
通过	tong guo	802
统计分析	tong ji fen xi	817
同时废止	tong shi fei zhi	1
同时设计	tong shi she ji	1189
同时设计同时施工同时投入生产和使用	tong shi she ji tong shi shi gong tong shi tou ru sheng chan he shi yong	1421
同时施工	tong shi shi gong	1188
同时投入生产和使用	tong shi tou ru sheng chan he shi yong	1187
统一协调管理	tong yi xie tiao guan li	1287
投入生产和使用	tou ru sheng chan he shi yong	1186
投入使用	tou ru shi yong	656
投资人	tou zi ren	750
妥善保存	tuo shan bao cun	361
妥善保存现场重要痕迹物证	tuo shan bao cun xian chang zhong yao hen ji wu zheng	362
妥善保护	tuo shan bao hu	368
妥善保护事故现场以及相关证据	tuo shan bao hu shi gu xian chang yi ji xiang guan zheng ju	369
拖延不报	tuo yan bu bao	883
完善安全生产条件	wan shan an quan sheng chan tiao jian	1506
完整	wan zheng	465
为安全生产提供技术服务的中介机构	wei an quan sheng chan ti gong ji shu fu wu de zhong jie ji gou	1483
未按照对从业人员进行安全生产教育和培训	wei an zhao dui cong ye ren yuan jin xing an quan sheng chan jiao yu he pei xun	714
未按照规定	wei an zhao gui ding	697
未按照规定如实告知从业人员有关的安全生产事项的	wei an zhao gui ding ru shi gao zhi cong ye ren yuan you guan de an quan sheng chan shi xiang de	712
未按照规定设立安全生产管理机构或者配备安全生产管理人员的	wei an zhao gui ding she li an quan sheng chan guan li ji gou huo zhe pei bei an quan sheng chan guan li ren yuan de	717
未按照批准的安全设施设计施工的	wei an zhao pi zhun de an quan she shi she ji shi gong de	691
未采取可靠的安全措施或者不接受有关主管部门依法实施的监督管理的	wei cai qu ke kao de an quan cuo shi huo zhe bu jie shou you guan zhu guan bu men yi fa shi shi de jian du guan li de	637
未对安全设备进行经常性维护保养和定期检测的	wei dui an quan she bei jin xing jing chang xing wei hu bao yang he ding qi jian ce de	672
为发生事故的单位提供虚假证明的中介机构	wei fa sheng shi gu de dan wei ti gong xu jia zheng ming de zhong jie ji gou	62
违法所得	wei fa suo de	765
违法所得不足五万元的单处或者并处一万元以上五万元以下的罚款	wei fa suo de bu zu wu wan yuan de dan chu huo zhe bing chu yi wan yuan yi shang wu wan yuan yi xia de fa kuan	622
违法所得十万元以上的并处违法所得一倍以上五倍以下的罚款	wei fa suo de shi wan yuan yi shang de bing chu wei fa suo de yi bei yi shang wu bei yi xia de fa kuan	644
违法所得五万元以上的并处违法所得一倍以上五倍以下的罚款没有违法所得	wei fa suo de wu wan yuan yi shang de bing chu wei fa suo de yi bei yi shang wu bei yi xia de fa kuan mei you wei fa suo de	623
违法所得在五千元以上的并处违法所得二倍以上五倍以下的罚款	wei fa suo de zai wu qian yuan yi shang de bing chu wei fa suo de er bei yi shang wu bei yi xia de fa kuan	763
违反安全生产法律法规	wei fan an quan sheng chan fa lv fa gui	1182
违反安全生产规章制度或者操作规程的	wei fan an quan sheng chan gui zhang zhi du huo zhe cao zuo gui cheng de	589
违反本条例规定	wei fan ben tiao li gui ding	34
违反治安管理行为	wei fan zhi an guan li xing wei	109
维护保养	wei hu bao yang	908
维护保养检测应当作好记录并由有关人员签字	wei hu bao yang jian ce ying dang zuo hao ji lu bing you you guan ren yuan qian zi	1405
危及从业人员生命安全	wei ji cong ye ren yuan sheng ming an quan	1172
危及生产安全	wei ji sheng chan an quan	652
未建立专门安全管理制度	wei jian li zhuan men an quan guan li zhi du	638
未经取得专业资质的机构检测检验合格	wei jing qu de zhuan ye zi zhi de ji gou jian ce jian yan he ge	664
未经事故调查组组长允许	wei jing shi gu diao cha zu zu zhang yun xu	222
未经验收合格	wei jing yan shou he ge	686
未经依法批准擅自生产经营储存危险物品的	wei jing yi fa pi zhun shan zi sheng chan jing ying chu cun wei xian wu pin de	650
未经允许	wei jing yun xu	220
为其保密	wei qi bao mi	1019
未签订安全生产管理协议	wei qian ding an quan sheng chan guan li xie yi	609
委托	wei tuo	314
未为从业人员提供符合国家标准或者行业标准的劳动防护用品的	wei wei cong ye ren yuan ti gong fu he guo jia biao zhun huo zhe hang ye biao zhun de lao dong fang hu yong pin de	670
危险化学品	wei xian hua xue pin	527
危险区域内	wei xian qu yu nei	1069
危险物品	wei xian wu pin	1446
危险物品的容器运输工具	wei xian wu pin de rong qi yun shu gong ju	1403
危险物品的生产经营储存单位	wei xian wu pin de sheng chan jing ying chu cun dan wei	1439
危险物品的生产经营储存单位以及矿山建筑施工单位	wei xian wu pin de sheng chan jing ying chu cun dan wei yi ji kuang shan jian zhu shi gong dan wei	924
危险物品的生产经营储存单位以及矿山建筑施工单位的主要负责人	wei xian wu pin de sheng chan jing ying chu cun dan wei yi ji kuang shan jian zhu shi gong dan wei de zhu yao fu ze ren	716
危险物品容器	wei xian wu pin rong qi	667
危险物品运输工具	wei xian wu pin yun shu gong ju	666
危险因素	wei xian yin su	1355
危险作业	wei xian zuo ye	1368
未依法履行安全生产管理职责导致事故发生的依照下列规定处以罚款	wei yi fa lv xing an quan sheng chan guan li zhi ze dao zhi shi gu fa sheng de yi zhao xia lie gui ding chu yi fa kuan	80
未依法取得批准或者验收合格的单位	wei yi fa qu de pi zhun huo zhe yan shou he ge de dan wei	1130
未依法取得批准验收的单位	wei yi fa qu de pi zhun yan shou de dan wei	800
未在有较大危险因素的生产经营场所有关设施设备上设置明显的安全警示标志的	wei zai you jiao da wei xian yin su de sheng chan jing ying chang suo you guan she shi she bei shang she zhi ming xian de an quan jing shi biao zhi de	684
伪造	wei zao	104
未造成人员伤亡的一般事故	wei zao cheng ren yuan shang wang de yi ban shi gu	313
伪造或者故意破坏事故现场的	wei zao huo zhe gu yi po huai shi gu xian chang de	105
违章指挥	wei zhang zhi hui	1242
违章指挥强令冒险作业	wei zhang zhi hui qiang ling mao xian zuo ye	1177
未指定专职安全生产管理人员进行安全检查与协调的	wei zhi ding zhuan zhi an quan sheng chan guan li ren yuan jin xing an quan jian cha yu xie tiao de	608
温家宝	wen jia bao	511
无法保证安全	wu fa bao zheng an quan	1072
五年内不得担任任何生产经营单位的主要负责人	wu nian nei bu de dan ren ren he sheng chan jing ying dan wei de zhu yao fu ze ren	724
五千万万元以上一亿元以下直接经济损失的事故	wu qian wan wan yuan yi shang yi yi yuan yi xia zhi jie jing ji sun shi de shi gu	486
五十人以上一百人以下重伤	wu shi ren yi shang yi bai ren yi xia zhong shang	487
物证	wu zheng	353
下列用语的含义	xia lie yong yu de han yi	529
下落不明	xia luo bu ming	387
下同或者一亿元以上直接经济损失的事故	xia tong huo zhe yi yi yuan yi shang zhi jie jing ji sun shi de shi gu	490
现场安全管理	xian chang an quan guan li	1365
现场简图	xian chang jian tu	356
县级人民政府	xian ji ren min zheng fu	319
县级人民政府也可以委托事故发生单位组织事故调查组进行调查	xian ji ren min zheng fu ye ke yi wei tuo shi gu fa sheng dan wei zu zhi shi gu diao cha zu jin xing diao cha	312
县级以上地方各级人民政府	xian ji yi shang di fang ge ji ren min zheng fu	1495
县级以上地方各级人民政府负责安全生产监督管理的部门	xian ji yi shang di fang ge ji ren min zheng fu fu ze an quan sheng chan jian du guan li de bu men	820
县级以上地方各级人民政府应当根据本行政区域内的安全生产状况	xian ji yi shang di fang ge ji ren min zheng fu ying dang gen ju ben xing zheng qu yu nei de an quan sheng chan zhuang kuang	1163
县级以上地方各级人民政府应当组织有关部门	xian ji yi shang di fang ge ji ren min zheng fu ying dang zu zhi you guan bu men	931
县级以上地方各级人民政府有关部门在各自的职责范围内对有关的安全生产工作实施监督管理	xian ji yi shang di fang ge ji ren min zheng fu you guan bu men zai ge zi de zhi ze fan wei nei dui you guan de an quan sheng chan gong zuo shi shi jian du guan li	1491
县级以上各级人民政府及其有关部门	xian ji yi shang ge ji ren min zheng fu ji qi you guan bu men	947
县级以上人民政府	xian ji yi shang ren min zheng fu	452
县级以上人民政府安全生产监督管理部门	xian ji yi shang ren min zheng fu an quan sheng chan jian du guan li bu men	427
限期改正	xian qi gai zheng	722
现予公布施行	xian yu gong bu shi xing	514
向从业人员如实告知作业场所和工作岗位存在的危险因素防范措施以及事故应急措施	xiang cong ye ren yuan ru shi gao zhi zuo ye chang suo he gong zuo gang wei cun zai de wei xian yin su fang fan cuo shi yi ji shi gu ying ji cuo shi	1358
项目	xiang mu	1308
向社会公布	xiang she hui gong bu	129
向事故发生地县级以上人民政府安全生产监督管理部门	xiang shi gu fa sheng di xian ji yi shang ren min zheng fu an quan sheng chan jian du guan li bu men	429
相应资质	xiang ying zi zhi	1301
相应资质单位或者个人	xiang ying zi zhi dan wei huo zhe ge ren	625
向有关单位和人员了解情况	xiang you guan dan wei he ren yuan liao jie qing kuang	1092
消防安全	xiao fang an quan	1515
销毁	xiao hui	94
销毁有关证据资料	xiao hui you guan zheng ju zi liao	95
效能	xiao neng	285
新工艺新技术新材料新设备	xin gong yi xin ji shu xin cai liao xin she bei	1432
新建改建扩建工程项目	xin jian gai jian kuo jian gong cheng xiang mu	1426
新闻出版	xin wen chu ban	939
新闻出版广播电影电视等单位有进行安全生产宣传教育的义务	xin wen chu ban guang bo dian ying dian shi deng dan wei you jin xing an quan sheng chan xuan chuan jiao yu de yi wu	940
形成记录备查	xing cheng ji lu bei cha	996
形成书面材料	xing cheng shu mian cai liao	962
刑罚	xing fa	45
刑罚执行完毕	xing fa zhi xing wan bi	725
刑事处罚	xing shi chu fa	767
刑事责任	xing shi ze ren	149
行使职权	xing shi zhi quan	1097
行政部门的责任	xing zheng bu men de ze ren	830
行政处罚	xing zheng chu fa	1084
行政处罚的种类幅度	xing zheng chu fa de zhong lei fu du	23
行政处罚决定	xing zheng chu fa jue ding	1079
行政处分	xing zheng chu fen	810
行政法规	xing zheng fa gui	24
行政法规规定的权限和程序	xing zheng fa gui gui ding de quan xian he cheng xu	157
行政区域	xing zheng qu yu	291
虚假证明	xu jia zheng ming	42
许可	xu ke	1142
需要落实整改措施的报经有关负责人签字并督促落实	xu yao luo shi zheng gai cuo shi de bao jing you guan fu ze ren qian zi bing du cu luo shi	960
迅速采取有效措施	xun su cai qu you xiao cuo shi	896
迅速追捕归案	xun su zhui bu gui an	339
延长的时间最长不超过三十日	yan chang de shi jian zui chang bu chao guo san shi ri	165
延长期限	yan chang qi xian	206
严格检查	yan ge jian cha	1155
严格履行职责	yan ge lv xing zhi ze	450
严格执行	yan ge zhi xing	1360
严格遵守	yan ge zun shou	1210
验收	yan shou	1145
验收部门及其验收人员对验收结果负责	yan shou bu men ji qi yan shou ren yuan dui yan shou jie guo fu ze	1411
验收合格	yan shou he ge	685
验收合格后方可投入生产和使用	yan shou he ge hou fang ke tou ru sheng chan he shi yong	1412
验收通过	yan shou tong guo	1132
邀请	yao qing	277
要求被审查验收的单位购买其指定的安全设备器材或者其他产品的	yao qiu bei shen cha yan shou de dan wei gou mai qi zhi ding de an quan she bei qi cai huo zhe qi ta chan pin de	790
要求纠正	yao qiu jiu zheng	1179
要求限期改正	yao qiu xian qi gai zheng	1087
要求追究有关人员的责任	yao qiu zhui jiu you guan ren yuan de ze ren	1164
也可以授权或者委托有关部门组织事故调查组进行调查	ye ke yi shou quan huo zhe wei tuo you guan bu men zu zhi shi gu diao cha zu jin xing diao cha	315
业务秘密	ye wu mi mi	1021
一般事故	yi ban shi gu	481
一般事故上报至设区的市级人民政府安全生产监督管理部门	yi ban shi gu shang bao zhi she qu de shi ji ren min zheng fu an quan sheng chan jian du guan li bu men	409
依法采取执行措施	yi fa cai qu zhi xing cuo shi	541
依法参加	yi fa can jia	1278
依法撤销	yi fa che xiao	51
依法承担赔偿责任	yi fa cheng dan pei chang ze ren	552
依法承担责任	yi fa cheng dan ze ren	1255
依法调查处理	yi fa diao cha chu li	821
依法吊销	yi fa diao xiao	563
依法对生产经营单位执行有关安全生产的法律法规	yi fa dui sheng chan jing ying dan wei zhi xing you guan an quan sheng chan de fa lv fa gui	1103
依法给予行政处分	yi fa gei yu xing zheng chu fen	775
依法给予处分	yi fa ji yu chu fen	119
依法立案侦查	yi fa li an zhen cha	345
依法履行监督检查职责	yi fa lv xing jian du jian cha zhi ze	1039
依法履行监督检查职责应当予以配合不得拒绝阻挠	yi fa lv xing jian du jian cha zhi ze ying dang yu yi pei he bu de ju jue zu nao	1040
依法批准	yi fa pi zhun	649
依法强制执行	yi fa qiang zhi zhi xing	546
依法取得批准	yi fa qu de pi zhun	1121
依法实施的监督管理	yi fa shi shi de jian du guan li	635
依法享有工伤社会保险	yi fa xiang you gong shang she hui bao xian	1219
依法应当保密	yi fa ying dang bao mi	128
依法应当保密的除外	yi fa ying dang bao mi de chu wai	133
依法予以处理	yi fa yu yi chu li	1123
依法予以追究	yi fa yu yi zhui jiu	834
依法暂扣吊销其相关人员的执业资格	yi fa zan kou diao xiao qi xiang guan ren yuan de zhi ye zi ge	41
依法暂扣或者吊销其有关证照	yi fa zan kou huo zhe diao xiao qi you guan zheng zhao	68
依法暂停	yi fa zan ting	52
依法暂停或者撤销其与安全生产有关的执业资格岗位证书	yi fa zan ting huo zhe che xiao qi yu an quan sheng chan you guan de zhi ye zi ge gang wei zheng shu	66
依法追究	yi fa zhui jiu	150
依法追究事故责任者的责任	yi fa zhui jiu shi gu ze ren zhe de ze ren	453
依法追究刑事责任	yi fa zhui jiu xing shi ze ren	768
依法作出处理决定	yi fa zuo chu chu li jue ding	1050
以及依法为从业人员办理工伤社会保险的事项	yi ji yi fa wei cong ye ren yuan ban li gong shang she hui bao xian de shi xiang	1264
移交司法机关处理	yi jiao si fa ji guan chu li	242
已经采取的措施	yi jing cai qu de cuo shi	385
一九九一年十二月二十二日公布的企业职工伤亡事故报告和处理规定	yi jiu jiu yi nian shi er yue er shi er ri gong bu de qi ye zhi gong shang wang shi gu bao gao he chu li gui ding	2
一年年收入	yi nian nian shou ru	124
一千万万元以上五千万万元以下直接经济损失的事故	yi qian wan wan yuan yi shang wu qian wan wan yuan yi xia zhi jie jing ji sun shi de shi gu	482
一千万万元以下直接经济损失的事故	yi qian wan wan yuan yi xia zhi jie jing ji sun shi de shi gu	479
易燃易爆物品	yi ran yi bao wu pin	528
以下等级	yi xia deng ji	495
一小时内	yi xiao shi nei	430
依照本法	yi zhao ben fa	1082
依照本法第七十七条的规定追究法律责任	yi zhao ben fa di qi shi qi tiao de gui ding zhui jiu fa lv ze ren	826
依照本法和其他有关法律行政法规的规定作出行政处罚决定	yi zhao ben fa he qi ta you guan fa lv xing zheng fa gui de gui ding zuo chu xing zheng chu fa jue ding	1083
依照本条例的有关规定执行	yi zhao ben tiao li de you guan gui ding zhi xing	16
依照本条例规定	yi zhao ben tiao li gui ding	296
依照本条例规定应当由上级人民政府负责调查的	yi zhao ben tiao li gui ding ying dang you shang ji ren min zheng fu fu ze diao cha de	302
依照程序进行审查	yi zhao cheng xu jin xing shen cha	1137
依照法律	yi zhao fa lv	158
依照法律行政法规规定的权限和程序	yi zhao fa lv xing zheng fa gui gui ding de quan xian he cheng xu	163
依照规定上报事故情况	yi zhao gui ding shang bao shi gu qing kuang	418
依照其规定	yi zhao qi gui ding	555
依照前款规定处罚	yi zhao qian kuan gui ding chu fa	571
依照前款规定上报事故情况	yi zhao qian kuan gui ding shang bao shi gu qing kuang	407
依照刑法有关规定	yi zhao xing fa you guan gui ding	807
依照刑法有关规定追究刑事责任	yi zhao xing fa you guan gui ding zhui jiu xing shi ze ren	731
依照行政监察法的规定	yi zhao xing zheng jian cha fa de gui ding	991
依照有关法律法规的规定	yi zhao you guan fa lv fa gui de gui ding	1150
依照有关规定执行	yi zhao you guan gui ding zhi xing	15
依照有关规章制度给予处分	yi zhao you guan gui zhang zhi du ji yu chu fen	586
依照有关民事法律	yi zhao you guan min shi fa lv	1217
依照有关民事法律尚有获得赔偿的权利的有权向本单位提出赔偿要求	yi zhao you guan min shi fa lv shang you huo de pei chang de quan li de you quan xiang ben dan wei ti chu pei chang yao qiu	1218
隐瞒不报	yin man bu bao	885
隐匿	yin ni	98
因抢救人员防止事故扩大以及疏通交通等原因需要移动事故现场物件的	yin qiang jiu ren yuan fang zhi shi gu kuo da yi ji shu tong jiao tong deng yuan yin xu yao yi dong shi gu xian chang wu jian de	364
因生产安全事故受到损害的从业人员	yin sheng chan an quan shi gu shou dao sun hai de cong ye ren yuan	1220
因生产安全事故受到损害的从业人员依法享有工伤社会保险外	yin sheng chan an quan shi gu shou dao sun hai de cong ye ren yuan yi fa xiang you gong shang she hui bao xian wai	1221
因事故伤亡人数变化	yin shi gu shang wang ren shu bian hua	304
应当安排	ying dang an pai	1321
应当安排用于配备劳动防护用品进行安全生产培训的经费	ying dang an pai yong yu pei bei lao dong fang hu yong pin jin xing an quan sheng chan pei xun de jing fei	1324
应当按照	ying dang an zhao	862
应当撤销原批准	ying dang che xiao yuan pi zhun	1118
应当定期统计分析本行政区域内发生生产安全事故的情况并定期向社会公布	ying dang ding qi tong ji fen xi ben xing zheng qu yu nei fa sheng sheng chan an quan shi gu de qing kuang bing ding qi xiang she hui gong bu	819
应当对事故发生单位落实防范和整改措施的情况进行监督检查	ying dang dui shi gu fa sheng dan wei luo shi fang fan he zheng gai cuo shi de qing kuang jin xing jian du jian cha	136
应当附具	ying dang fu ju	189
应当归档保存	ying dang gui dang bao cun	175
应当互相配合提高事故调查处理工作的效率	ying dang hu xiang pei he ti gao shi gu diao cha chu li gong zuo de xiao lv	441
应当记录在案	ying dang ji lu zai an	1326
应当及时报告	ying dang ji shi bao gao	1333
应当及时处理	ying dang ji shi chu li	1153
应当及时移送其他有关部门并形成记录备查	ying dang ji shi yi song qi ta you guan bu men bing xing cheng ji lu bei cha	998
应当继续履行赔偿义务	ying dang ji xu lv xing pei chang yi wu	536
应当建立应急救援组织	ying dang jian li ying ji jiu yuan zu zhi	923
应当具备国家规定的资质条件	ying dang ju bei guo jia gui ding de zi zhi tiao jian	979
应当具有	ying dang ju you	272
应当立即按照国家有关规定上报事故情况	ying dang li ji an zhao guo jia you guan gui ding shang bao shi gu qing kuang	878
应当立即报告	ying dang li ji bao gao	900
应当立即报告国务院	ying dang li ji bao gao guo wu yuan	403
应当立即处理	ying dang li ji chu li	1337
应当立即赶到事故现场组织事故抢救	ying dang li ji gan dao shi gu xian chang zu zhi shi gu qiang jiu	871
应当立即向现场安全生产管理人员	ying dang li ji xiang xian chang an quan sheng chan guan li ren yuan	1195
应当立即向现场安全生产管理人员或者本单位负责人报告	ying dang li ji xiang xian chang an quan sheng chan guan li ren yuan huo zhe ben dan wei fu ze ren bao gao	1198
应当立即予以取缔	ying dang li ji yu yi qu di	1124
应当立即组织抢救	ying dang li ji zu zhi qiang jiu	1282
应当配备	ying dang pei bei	913
应当配备必要的应急救援器材设备	ying dang pei bei bi yao de ying ji jiu yuan qi cai she bei	914
应当签订安全生产管理协议	ying dang qian ding an quan sheng chan guan li xie yi	1316
应当设有符合紧急疏散要求标志明显保持畅通的出口	ying dang she you fu he jin ji shu san yao qiu biao zhi ming xian bao chi chang tong de chu kou	1378
应当同时报告本级人民政府	ying dang tong shi bao gao ben ji ren min zheng fu	406
应当为其保密	ying dang wei qi bao mi	1020
应当委托	ying dang wei tuo	238
应当向当地人民政府或者有关部门报告	ying dang xiang dang di ren min zheng fu huo zhe you guan bu men bao gao	948
应当形成书面材料	ying dang xing cheng shu mian cai liao	963
应当迅速采取有效措施组织抢救防止事故扩大减少人员伤亡和财产损失	ying dang xun su cai qu you xiao cuo shi zu zhi qiang jiu fang zhi shi gu kuo da jian shao ren yuan shang wang he cai chan sun shi	897
应当依法履行安全生产方面的义务	ying dang yi fa lv xing an quan sheng chan fang mian de yi wu	1502
应当依照本条例的规定	ying dang yi zhao ben tiao li de gui ding	451
应当依照下列规定上报事故情况	ying dang yi zhao xia lie gui ding shang bao shi gu qing kuang	419
应当由上级人民政府负责调查	ying dang you shang ji ren min zheng fu fu ze diao cha	295
应当与承包单位承租单位签订专门的安全生产管理协议	ying dang yu cheng bao dan wei cheng zu dan wei qian ding zhuan men de an quan sheng chan guan li xie yi	1295
应当予以配合	ying dang yu yi pei he	1038
应当与员工宿舍保持安全距离	ying dang yu yuan gong su she bao chi an quan ju li	1383
应当载明	ying dang zai ming	1270
应当载明有关保障从业人员劳动安全防止职业危害的事项	ying dang zai ming you guan bao zhang cong ye ren yuan lao dong an quan fang zhi zhi ye wei hai de shi xiang	1271
应当责令从危险区域内撤出作业人员	ying dang ze ling cong wei xian qu yu nei che chu zuo ye ren yuan	1071
应当支持配合上级人民政府或者有关部门的事故调查处理工作	ying dang zhi chi pei he shang ji ren min zheng fu huo zhe you guan bu men de shi gu diao cha chu li gong zuo	447
应当自收到事故调查报告之日起十五日内做出批复	ying dang zi shou dao shi gu diao cha bao gao zhi ri qi shi wu ri nei zuo chu pi fu	170
应当做出标志绘制现场简图并做出书面记录	ying dang zuo chu biao zhi hui zhi xian chang jian tu bing zuo chu shu mian ji lu	363
应急处理能力	ying ji chu li neng li	1200
应急救援	ying ji jiu yuan	1523
应急救援器材设备	ying ji jiu yuan qi cai she bei	911
应急救援人员	ying ji jiu yuan ren yuan	915
应急救援体系	ying ji jiu yuan ti xi	926
应急救援预案	ying ji jiu yuan yu an	927
应急救援组织	ying ji jiu yuan zu zhi	920
用于配备劳动防护用品	yong yu pei bei lao dong fang hu yong pin	1323
用于生产储存危险物品的建设项目	yong yu sheng chan chu cun wei xian wu pin de jian she xiang mu	700
有对违反安全生产法律法规的行为进行舆论监督的权利	you dui wei fan an quan sheng chan fa lv fa gui de xing wei jin xing yu lun jian du de quan li	936
有根据认为	you gen ju ren wei	1057
由公安机关依法给予治安管理处罚	you gong an ji guan yi fa gei yu zhi an guan li chu fa	108
有功人员	you gong ren yuan	943
有关安全生产的法律法规	you guan an quan sheng chan de fa lv fa gui	1101
有关部门	you guan bu men	327
有关部门应当依法吊销其有关证照	you guan bu men ying dang yi fa diao xiao qi you guan zheng zhao	564
有关材料	you guan cai liao	244
有关单位和个人不得拒绝	you guan dan wei he ge ren bu de ju jue	253
有关地方人民政府	you guan di fang ren min zheng fu	570
有关地方人民政府和负有安全生产监督管理职责的部门的负责人	you guan di fang ren min zheng fu he fu you an quan sheng chan jian du guan li zhi ze de bu men de fu ze ren	874
有关地方人民政府或者有关部门	you guan di fang ren min zheng fu huo zhe you guan bu men	33
有关地方政府安监部门和负有安监职责的有关部门有下列行为之一的	you guan di fang zheng fu an jian bu men he fu you an jian zhi ze de you guan bu men you xia lie xing wei zhi yi de	75
有关法律行政法规对行政处罚的决定机关另有规定的依照其规定	you guan fa lv xing zheng fa gui dui xing zheng chu fa de jue ding ji guan ling you gui ding de yi zhao qi gui ding	556
有关法律行政法规或者国务院另有规定的依照其规定	you guan fa lv xing zheng fa gui huo zhe guo wu yuan ling you gui ding de yi zhao qi gui ding	7
有关负责人	you guan fu ze ren	1331
有关活动	you guan huo dong	1128
有关机关	you guan ji guan	160
有关机关应当按照人民政府的批复	you guan ji guan ying dang an zhao ren min zheng fu de pi fu	164
有关情况	you guan qing kuang	247
有关人员	you guan ren yuan	901
有关设施设备上	you guan she shi she bei shang	682
有关事故信息	you guan shi gu xin xi	218
有关证据材料	you guan zheng ju cai liao	187
有关证照	you guan zheng zhao	562
由监察机关对有关责任人员依法给予处分	you jian cha ji guan dui you guan ze ren ren yuan yi fa ji yu chu fen	28
由其上级机关或者监察机关责令改正	you qi shang ji ji guan huo zhe jian cha ji guan ze ling gai zheng	785
有前款违法行为的	you qian kuan wei fa xing wei de	738
有权对本单位安全生产工作中存在的问题提出批评检举控告	you quan dui ben dan wei an quan sheng chan gong zuo zhong cun zai de wen ti ti chu pi ping jian ju kong gao	1248
有权对本单位的安全生产工作提出建议	you quan dui ben dan wei de an quan sheng chan gong zuo ti chu jian yi	1250
有权拒绝违章指挥	you quan ju jue wei zhang zhi hui	1243
有权拒绝违章指挥和强令冒险作业	you quan ju jue wei zhang zhi hui he qiang ling mao xian zuo ye	1244
有权了解	you quan liao jie	1253
有权提出解决的建议	you quan ti chu jie jue de jian yi	1176
有权停止作业或者在采取可能的应急措施后撤离作业场所	you quan ting zhi zuo ye huo zhe zai cai qu ke neng de ying ji cuo shi hou che li zuo ye chang suo	1230
有权向本单位提出赔偿要求	you quan xiang ben dan wei ti chu pei chang yao qiu	1214
有权要求纠正	you quan yao qiu jiu zheng	1180
由生产经营单位给予批评教育	you sheng chan jing ying dan wei gei yu pi ping jiao yu	588
由事故发生地人民政府负责调查	you shi gu fa sheng di ren min zheng fu fu ze diao cha	290
有下列行为之一的	you xia lie xing wei zhi yi de	813
有效的监督执法证件	you xiao de jian du zhi fa zheng jian	1027
有效实施	you xiao shi shi	1461
由有关部门依法暂扣或者吊销其有关证照及其相关人员的执业资格	you you guan bu men yi fa zan kou huo zhe diao xiao qi you guan zheng zhao ji qi xiang guan ren yuan de zhi ye zi ge	61
由专业生产单位生产	you zhuan ye sheng chan dan wei sheng chan	1401
与安全生产有关的执业资格岗位证书	yu an quan sheng chan you guan de zhi ye zi ge gang wei zheng shu	50
与承包方承租方承担连带赔偿责任	yu cheng bao fang cheng zu fang cheng dan lian dai pei chang ze ren	618
舆论监督	yu lun jian du	934
逾期未改正	yu qi wei gai zheng	741
逾期未改正的	yu qi wei gai zheng de	721
逾期未改正的责令生产经营单位停产停业整顿	yu qi wei gai zheng de ze ling sheng chan jing ying dan wei ting chan ting ye zheng dun	742
逾期未改正的责令停产停业整顿	yu qi wei gai zheng de ze ling ting chan ting ye zheng dun	641
逾期未改正的责令停止建设或者停产停业整顿	yu qi wei gai zheng de ze ling ting zhi jian she huo zhe ting chan ting ye zheng dun	706
予以保证	yu yi bao zheng	1451
予以查封	yu yi cha feng	1053
予以关闭	yu yi guan bi	645
予以关闭的行政处罚由负责安全生产监督管理的部门	yu yi guan bi de xing zheng chu fa you fu ze an quan sheng chan jian du guan li de bu men	560
予以批准验收通过	yu yi pi zhun yan shou tong guo	803
与员工宿舍的距离不符合安全要求	yu yuan gong su she de ju li bu fu he an quan yao qiu	602
与员工宿舍在同一座建筑内	yu yuan gong su she zai tong yi zuo jian zhu nei	604
员工宿舍	yuan gong su she	1379
员工宿舍出口	yuan gong su she chu kou	1372
原则	yuan ze	284
越级上报	yue ji shang bao	399
运输工具	yun shu gong ju	665
再次发生	zai ci fa sheng	141
在对安全生产事项的审查验收中收取费用的	zai dui an quan sheng chan shi xiang de shen cha yan shou zhong shou qu fei yong de	787
在紧急情况下停止作业或者采取紧急撤离措施	zai jin ji qing kuang xia ting zhi zuo ye huo zhe cai qu jin ji che li cuo shi	1226
在事故调查处理期间	zai shi gu diao cha chu li qi jian	1281
在事故调查处理期间擅离职守的	zai shi gu diao cha chu li qi jian shan li zhi shou de	115
在事故调查中作伪证或者指使他人作伪证的	zai shi gu diao cha zhong zuo wei zheng huo zhe zhi shi ta ren zuo wei zheng de	90
在同一座建筑内	zai tong yi zuo jian zhu nei	603
在同一作业区域内	zai tong yi zuo ye qu yu nei	1319
在同一作业区域内进行可能危及对方安全生产的生产经营活动	zai tong yi zuo ye qu yu nei jin xing ke neng wei ji dui fang an quan sheng chan de sheng chan jing ying huo dong	611
暂扣	zan kou	55
暂行规定	zan xing gui ding	3
造成人身伤亡直接经济损失的	zao cheng ren shen shang wang zhi jie jing ji sun shi de	504
造成人员伤亡和直接经济损失	zao cheng ren yuan shang wang he zhi jie jing ji sun shi	196
造成严重后果构成犯罪的依照刑法有关规定追究刑事责任	zao cheng yan zhong hou guo gou cheng fan zui de yi zhao xing fa you guan gui ding zhui jiu xing shi ze ren	703
造成重大事故	zao cheng zhong da shi gu	582
造成重大事故构成犯罪的依照刑法有关规定追究刑事责任	zao cheng zhong da shi gu gou cheng fan zui de yi zhao xing fa you guan gui ding zhui jiu xing shi ze ren	583
责令从危险区域内撤出作业人员	ze ling cong wei xian qu yu nei che chu zuo ye ren yuan	1070
责令改正	ze ling gai zheng	783
责令立即排除	ze ling li ji pai chu	1077
责令生产经营单位停产停业整顿	ze ling sheng chan jing ying dan wei ting chan ting ye zheng dun	740
责令停产停业整顿	ze ling ting chan ting ye zheng dun	720
责令停止建设	ze ling ting zhi jian she	705
责令停止违法行为	ze ling ting zhi wei fa xing wei	646
责令停止违法行为或者予以关闭	ze ling ting zhi wei fa xing wei huo zhe yu yi guan bi	647
责令退还	ze ling tui huan	781
责令退还收取的费用	ze ling tui huan shou qu de fei yong	782
责令限期改正	ze ling xian qi gai zheng	744
责令限期改正没收违法所得	ze ling xian qi gai zheng mo shou wei fa suo de	624
责令限期改正提供必需的资金	ze ling xian qi gai zheng ti gong bi xu de zi jin	745
责令限期改正逾期未改正的责令停产停业整顿	ze ling xian qi gai zheng yu qi wei gai zheng de ze ling ting chan ting ye zheng dun	612
责令暂时停产停业	ze ling zan shi ting chan ting ye	1066
责令暂时停产停业或者停止使用	ze ling zan shi ting chan ting ye huo zhe ting zhi shi yong	1067
责任认定	ze ren ren ding	193
责任事故	ze ren shi gu	837
增强事故预防	zeng qiang shi gu yu fang	1201
掌握本职工作所需的安全生产知识	zhang wo ben zhi gong zuo suo xu de an quan sheng chan zhi shi	1204
侦查措施	zhen cha cuo shi	341
正常生产经营活动	zheng chang sheng chan jing ying huo dong	1045
正常运转	zheng chang yun zhuan	906
整改措施	zheng gai cuo shi	848
证据材料	zheng ju cai liao	186
正确佩戴使用	zheng que pei dai shi yong	1207
治安管理处罚	zhi an guan li chu fa	107
值班制度	zhi ban zhi du	336
支持督促各有关部门依法履行安全生产监督管理职责	zhi chi du cu ge you guan bu men yi fa lv xing an quan sheng chan jian du guan li zhi ze	1498
支持配合	zhi chi pei he	446
支持配合事故抢救	zhi chi pei he shi gu qiang jiu	866
指定	zhi ding	263
制定本行政区域内特大生产安全事故应急救援预案	zhi ding ben xing zheng qu yu nei te da sheng chan an quan shi gu ying ji jiu yuan yu an	930
指定兼职的应急救援人员	zhi ding jian zhi de ying ji jiu yuan ren yuan	916
指定生产销售单位	zhi ding sheng chan xiao shou dan wei	1106
制定事故等级划分	zhi ding shi gu deng ji hua fen	475
制定应急预案	zhi ding ying ji yu an	631
执法证件	zhi fa zheng jian	1025
直接负责的主管人员和其他直接责任人员依法给予行政处分	zhi jie fu ze de zhu guan ren yuan he qi ta zhi jie ze ren ren yuan yi fa gei yu xing zheng chu fen	569
直接经济损失	zhi jie jing ji sun shi	497
直接利害关系	zhi jie li hai guan xi	269
直接危及人身安全	zhi jie wei ji ren shen an quan	1232
直接组织	zhi jie zu zhi	317
致使	zhi shi	40
知识和管理能力	zhi shi he guan li neng li	1440
知识和专长	zhi shi he zhuan chang	271
致使生产经营单位不具备安全生产条件的	zhi shi sheng chan jing ying dan wei bu ju bei an quan sheng chan tiao jian de	746
致使事故调查工作有重大疏漏的	zhi shi shi gu diao cha gong zuo you zhong da shu lou de	58
指使他人作伪证	zhi shi ta ren zuo wei zheng	88
执行监督检查任务时	zhi xing jian du jian cha ren wu shi	1030
执行完毕	zhi xing wan bi	44
执行有关安全生产的法律法规	zhi xing you guan an quan sheng chan de fa lv fa gui	1102
职业危害	zhi ye wei hai	1265
执业准则	zhi ye zhun ze	1481
执业资格	zhi ye zi ge	49
重大生产安全事故报告	zhong da sheng chan an quan shi gu bao gao	872
重大事故	zhong da shi gu	489
重大事故较大事故一般事故	zhong da shi gu jiao da shi gu yi ban shi gu	325
重大事故较大事故一般事故负责事故调查的人民政府	zhong da shi gu jiao da shi gu yi ban shi gu fu ze shi gu diao cha de ren min zheng fu	172
重大事故隐患排除后	zhong da shi gu yin huan pai chu hou	1062
重大事故隐患排除后经审查同意方可恢复生产经营和使用	zhong da shi gu yin huan pai chu hou jing shen cha tong yi fang ke hui fu sheng chan jing ying he shi yong	1063
重大事故隐患排除前或者排除过程中	zhong da shi gu yin huan pai chu qian huo zhe pai chu guo cheng zhong	1075
重大事故隐患排除前或者排除过程中无法保证安全的	zhong da shi gu yin huan pai chu qian huo zhe pai chu guo cheng zhong wu fa bao zheng an quan de	1076
重大危险源	zhong da wei xian yuan	1389
中华人民共和国	zhong hua ren min gong he guo	1534
中华人民共和国安全生产法	zhong hua ren min gong he guo an quan sheng chan fa	1532
中华人民共和国国务院	zhong hua ren min gong he guo guo wu yuan	1533
中华人民共和国国务院四九三号令	zhong hua ren min gong he guo guo wu yuan si jiu san hao ling	516
中华人民共和国领域内	zhong hua ren min gong he guo ling yu nei	1517
中介机构	zhong jie ji gou	1482
忠于职守	zhong yu zhi shou	1034
忠于职守坚持原则秉公执法	zhong yu zhi shou jian chi yuan ze bing gong zhi fa	1035
注册	zhu ce	1141
主持事故调查组工作	zhu chi shi gu diao cha zu gong zuo	264
主管部门	zhu guan bu men	1437
逐级上报	zhu ji shang bao	396
逐级上报事故情况	zhu ji shang bao shi gu qing kuang	395
主体工程	zhu ti gong cheng	1423
主要负责人	zhu yao fu ze ren	1453
专业技术资格	zhuan ye ji shu zi ge	1443
专业资质机构	zhuan ye zi zhi ji gou	663
转移	zhuan yi	99
转移隐匿	zhuan yi yin ni	101
转移隐匿资金财产或者销毁有关证据资料的	zhuan yi yin ni zi jin cai chan huo zhe xiao hui you guan zheng ju zi liao de	102
专职安全生产管理人员	zhuan zhi an quan sheng chan guan li ren yuan	1312
追捕归案	zhui bu gui an	338
追究法律责任	zhui jiu fa lv ze ren	825
追究生产安全事故责任人员	zhui jiu sheng chan an quan shi gu ze ren ren yuan	1478
追究刑事责任	zhui jiu xing shi ze ren	806
准确	zhun que	466
自发生之日起七日内	zi fa sheng zhi ri qi qi ri nei	305
资金	zi jin	97
资金财产	zi jin cai chan	100
资金投入	zi jin tou ru	747
资金投入不足	zi jin tou ru bu zu	1450
自事故发生之日起三十日内	zi shi gu fa sheng zhi ri qi san shi ri nei	381
自刑罚执行完毕	zi xing fa zhi xing wan bi	64
自刑罚执行完毕或者受处分之日起	zi xing fa zhi xing wan bi huo zhe shou chu fen zhi ri qi	726
资质条件	zi zhi tiao jian	977
总结事故教训	zong jie shi gu jiao xun	851
总理温家宝	zong li wen jia bao	512
总则	zong ze	510
阻碍	zu ai	71
阻碍干涉事故调查工作的	zu ai gan she shi gu diao cha gong zuo de	72
足额赔偿	zu e pei chang	537
租赁合同	zu lin he tong	1291
租赁合同中约定	zu lin he tong zhong yue ding	1290
组织从业人员撤离危险场所	zu zhi cong ye ren yuan che li wei xian chang suo	1171
组织抢救	zu zhi qiang jiu	1275
组织事故救援	zu zhi shi gu jiu yuan	374
组织事故抢救	zu zhi shi gu qiang jiu	869
组织有关部门	zu zhi you guan bu men	1160
组织有关部门按照职责分工	zu zhi you guan bu men an zhao zhi ze fen gong	1161
组织制定	zu zhi zhi ding	1466
组织专家	zu zhi zhuan jia	233
最长不超过六十日	zui chang bu chao guo liu shi ri	207
遵守纪律	zun shou ji lv	224
遵守事故调查组的纪律	zun shou shi gu diao cha zu de ji lv	226
遵循	zun xun	287
尊重科学	zun zhong ke xue	859
做出	zuo chu	355
做出标志	zuo chu biao zhi	360
做出批复	zuo chu pi fu	169
作出书面记录	zuo chu shu mian ji lu	1014
做出书面记录	zuo chu shu mian ji lu	358
作出行政处罚决定	zuo chu xing zheng chu fa jue ding	1080
作伪证	zuo wei zheng	89
作业场所	zuo ye chang suo	1252
作业过程中	zuo ye guo cheng zhong	1211
