# 文件名：站长网站.scel
# 词库名：站长网站
# 词库分类：互联网
# 词库描述：
# 词条样例：创业网 站长平台 站长工具 旗胜站长网 站长圈 好站长资源
# 词条数量：27

爱站网	ai zhan wang	19
百度统计	bai du tong ji	11
创业网	chuang ye wang	25
好站长资源	hao zhan zhang zi yuan	10
互站网	hu zhan wang	27
科站网	ke zhan wang	1
麦布站长网	mai bu zhan zhang wang	3
美潇网	mei xiao wang	26
旗胜站长网	qi sheng zhan zhang wang	18
搜狗站长平台	sou gou zhan zhang ping tai	17
网站站长	wang zhan zhan zhang	4
五一八八网	wu yi ba ba wang	2
小蚂蚁站长吧	xiao ma yi zhan zhang ba	6
一团网	yi tuan wang	16
站帮网	zhan bang wang	15
站长	zhan zhang	23
站长吧	zhan zhang ba	12
站长工具	zhan zhang gong ju	20
站长平台	zhan zhang ping tai	24
站长圈	zhan zhang quan	14
站长视角网	zhan zhang shi jiao wang	5
站长天空	zhan zhang tian kong	9
站长网	zhan zhang wang	21
站长之家	zhan zhang zhi jia	22
站长资源大全	zhan zhang zi yuan da quan	8
站长资源平台	zhan zhang zi yuan ping tai	13
中国站长站	zhong guo zhan zhang zhan	7
