# 文件名：盆景艺术.scel
# 词库名：盆景艺术
# 词库分类：林业
# 词库描述：
# 词条样例：盆景艺术创作词汇 盆景风格流派名称 盆景制作专用工具名称 盆景几架盆钵名称 盆景专用药液名称 盆景养护与管理专用辞汇
# 词条数量：14

各类盆景题名总汇	ge lei pen jing ti ming zong hui	10
盆景常用树种石种名称	pen jing chang yong shu zhong shi zhong ming cheng	8
盆景风格流派名称	pen jing feng ge liu pai ming cheng	11
盆景几架盆钵名称	pen jing ji jia pen bo ming cheng	7
盆景理论文献名称	pen jing li lun wen xian ming cheng	12
盆景饰件名称	pen jing shi jian ming cheng	5
盆景养护与管理专用辞汇	pen jing yang hu yu guan li zhuan yong ci hui	2
盆景艺术创作词汇	pen jing yi shu chuang zuo ci hui	13
盆景制作专用工具名称	pen jing zhi zuo zhuan yong gong ju ming cheng	9
盆景专业术语	pen jing zhuan ye shu yu	14
盆景专用肥料名称	pen jing zhuan yong fei liao ming cheng	3
盆景专用药液名称	pen jing zhuan yong yao ye ming cheng	4
全国盆景艺术名人录	quan guo pen jing yi shu ming ren lu	1
全国盆景园名称	quan guo pen jing yuan ming cheng	6
