# 文件名：赵中举的词库.scel
# 词库名：赵中举的词库
# 词库分类：农业
# 词库描述：
# 词条样例：大芦乡刘沟村 大芦乡野糜村 高湾乡二百户村 高湾乡葛淌村 高湾乡文崖村 高湾乡贾崖村
# 词条数量：41

大芦乡	da lu xiang	32
大芦乡常塬村	da lu xiang chang yuan cun	41
大芦乡大芦村	da lu xiang da lu cun	33
大芦乡大塬村	da lu xiang da yuan cun	39
大芦乡刘沟村	da lu xiang liu gou cun	38
大芦乡小芦村	da lu xiang xiao lu cun	40
大芦乡野糜村	da lu xiang ye mi cun	34
大芦乡中砂村	da lu xiang zhong sha cun	36
大芦乡周湾村	da lu xiang zhou wan cun	35
大芦乡庄口村	da lu xiang zhuang kou cun	37
高湾乡	gao wan xiang	16
高湾乡白崖村	gao wan xiang bai ya cun	26
高湾乡二百户村	gao wan xiang er bai hu cun	28
高湾乡高崖村	gao wan xiang gao ya cun	22
高湾乡葛淌村	gao wan xiang ge tang cun	25
高湾乡贾崖村	gao wan xiang jia ya cun	23
高湾乡笠山村	gao wan xiang li shan cun	19
高湾乡马寨村	gao wan xiang ma zhai cun	18
高湾乡三百户村	gao wan xiang san bai hu cun	27
高湾乡三场村	gao wan xiang san chang cun	21
高湾乡沙河村	gao wan xiang sha he cun	20
高湾乡文崖村	gao wan xiang wen ya cun	24
高湾乡住寨村	gao wan xiang zhu zhai cun	17
教导处	jiao dao chu	4
靖远县大芦信用社	jing yuan xian da lu xin yong she	1
靖远县大芦中心小学	jing yuan xian da lu zhong xin xiao xue	2
靖远县大芦中学	jing yuan xian da lu zhong xue	3
刘川乡	liu chuan xiang	5
刘川乡范窑村	liu chuan xiang fan yao cun	10
刘川乡金川村	liu chuan xiang jin chuan cun	12
刘川乡来窑村	liu chuan xiang lai yao cun	7
刘川乡涝坝湾村	liu chuan xiang lao ba wan cun	15
刘川乡罗庄村	liu chuan xiang luo zhuang cun	9
刘川乡南川村	liu chuan xiang nan chuan cun	8
刘川乡南山尾村	liu chuan xiang nan shan wei cun	14
刘川乡鹰嘴村	liu chuan xiang ying zui cun	13
刘川乡张滩村	liu chuan xiang zhang tan cun	6
刘川乡赵淌村	liu chuan xiang zhao tang cun	11
赵广发	zhao guang fa	29
赵映新	zhao ying xin	30
赵中举	zhao zhong ju	31
