# 文件名：中西医皮肤科诊断对照.scel
# 词库名：中西医皮肤科诊断对照
# 词库分类：中医
# 词库描述：
# 词条样例：脓疱疮黄水疮暑湿热蕴 银屑病白疕风热血燥 脂溢性皮炎面游风肺胃热盛 痤疮粉刺湿热蕴结 斑秃油风肝肾不足 结节性红斑瓜藤缠湿热瘀阻
# 词条数量：18

斑秃油风肝肾不足	ban tu you feng gan shen bu zu	6
痤疮粉刺湿热蕴结	cuo chuang fen ci shi re yun jie	7
带状疱疹蛇串疮肝经郁热	dai zhuang pao zhen she chuan chuang gan jing yu re	17
多形红斑猫眼疮湿热蕴结	duo xing hong ban mao yan chuang shi re yun jie	4
过敏性紫癜紫癜风热伤络	guo min xing zi dian zi dian feng re shang luo	18
红斑狼疮红蝴蝶疮热毒炽盛	hong ban lang chuang hong hu die chuang re du chi sheng	3
黄褐斑黧黑斑肝肾不足	huang he ban li hei ban gan shen bu zu	2
结节性红斑瓜藤缠湿热瘀阻	jie jie xing hong ban gua teng chan shi re yu zu	5
玫瑰糠疹风热疮风热犯表	mei gui kang zhen feng re chuang feng re fan biao	1
脓疱疮黄水疮暑湿热蕴	nong pao chuang huang shui chuang shu shi re yun	15
丘疹性荨麻疹虫咬皮炎热毒蕴结	qiu zhen xing xun ma zhen chong yao pi yan re du yun jie	13
神经性皮炎牛皮癣肝经化火	shen jing xing pi yan niu pi xuan gan jing hua huo	10
湿疹湿疮湿热侵淫	shi zhen shi chuang shi re qin yin	12
寻常疣疣热毒蕴结	xun chang you you re du yun jie	16
荨麻疹瘾疹风热犯表	xun ma zhen yin zhen feng re fan biao	11
银屑病白疕风热血燥	yin xie bing bai bi feng re xue zao	9
脂溢性皮炎面游风肺胃热盛	zhi yi xing pi yan mian you feng fei wei re sheng	8
足癣癣湿热下注	zu xuan xuan shi re xia zhu	14
