# 文件名：养生.scel
# 词库名：养生
# 词库分类：中医
# 词库描述：
# 词条样例：米微柜式新风空气净化器 壁挂式新风空气净化器米微 超滤净水器米微 米微空气净化器 中央净水米微
# 词条数量：26

壁挂式新风空气净化器米微	bi gua shi xin feng kong qi jing hua qi mi wei	14
超滤净水器米微	chao lv jing shui qi mi wei	21
车载空气净化器米微	che zai kong qi jing hua qi mi wei	4
厨下净水米微	chu xia jing shui mi wei	10
儿童防雾霾口罩米微	er tong fang wu mai kou zhao mi wei	6
防雾霾喉罩米微	fang wu mai hou zhao mi wei	8
柜式新风空气净化器米微	gui shi xin feng kong qi jing hua qi mi wei	12
空气净化器米微	kong qi jing hua qi mi wei	26
米微	mi wei	2
米微壁挂式新风空气净化器	mi wei bi gua shi xin feng kong qi jing hua qi	13
米微超滤净水器	mi wei chao lv jing shui qi	17
米微车载空气净化器	mi wei che zai kong qi jing hua qi	3
米微厨下净水	mi wei chu xia jing shui	9
米微儿童房雾霾口罩	mi wei er tong fang wu mai kou zhao	5
米微房屋霾口罩	mi wei fang wu mai kou zhao	7
米微柜式新风空气净化器	mi wei gui shi xin feng kong qi jing hua qi	11
米微空气净化器	mi wei kong qi jing hua qi	24
米微前置净水器	mi wei qian zhi jing shui qi	18
米微软水机	mi wei ruan shui ji	16
米微新风空气净化器	mi wei xin feng kong qi jing hua qi	23
米微中央净水	mi wei zhong yang jing shui	15
前置净水器米微	qian zhi jing shui qi mi wei	22
软水机米微	ruan shui ji mi wei	20
新风空气净化器米微	xin feng kong qi jing hua qi mi wei	25
远大米微	yuan da mi wei	1
中央净水米微	zhong yang jing shui mi wei	19
