# 文件名：我的工作词库(药店药品).scel
# 词库名：我的工作词库(药店药品)
# 词库分类：西药学
# 词库描述：
# 词条样例：黄芪颗粒 六味地黄胶囊 巴氯芬片 百令胶囊 板蓝根颗粒 胞磷胆碱钠胶囊
# 词条数量：48

阿苯达唑片	a ben da zuo pian	8
阿达帕林凝胶	a da pa lin ning jiao	7
阿德福韦酯胶囊	a de fu wei zhi jiao nang	6
阿法骨化醇软胶囊	a fa gu hua chun ruan jiao nang	5
阿卡波糖片	a ka bo tang pian	4
阿仑膦酸钠片	a lun lin suan na pian	3
阿莫西林分散片	a mo xi lin fen san pian	2
阿莫西林胶囊	a mo xi lin jiao nang	1
奥美拉唑肠溶胶囊	ao mei la zuo chang rong jiao nang	10
奥硝唑片	ao xiao zuo pian	41
奥硝唑阴道栓	ao xiao zuo yin dao shuan	40
八宝惊风散	ba bao jing feng san	39
巴氯芬片	ba lv fen pian	38
百补增力丸	bai bu zeng li wan	36
百令胶囊	bai ling jiao nang	35
百蕊片	bai rui pian	34
白芍总苷胶囊	bai shao zong gan jiao nang	37
柏子养心丸	bai zi yang xin wan	33
板蓝根颗粒	ban lan gen ke li	32
保妇康凝胶	bao fu kang ning jiao	28
保和丸浓缩丸	bao he wan nong suo wan	27
胞磷胆碱钠胶囊	bao lin dan jian na jiao nang	30
胞磷胆碱钠片	bao lin dan jian na pian	29
包醛氧淀粉	bao quan yang dian fen	31
保心宁片	bao xin ning pian	26
贝前列素钠片	bei qian lie su na pian	25
苯巴比妥东莨菪碱片	ben ba bi tuo dong lang dang jian pian	24
苯磺贝他斯汀片	ben huang bei ta si ting pian	23
苯磺酸氨氯地平滴丸	ben huang suan an lv di ping di wan	22
苯磺酸氨氯地平片	ben huang suan an lv di ping pian	21
厄贝沙坦氢氯噻嗪片	e bei sha tan qing lv sai qin pian	12
复方青黛丸	fu fang qing dai wan	16
谷氨酰胺呱仑酸钠颗粒	gu an xian an gua lun suan na ke li	9
关节止痛膏	guan jie zhi tong gao	13
黄芪颗粒	huang qi ke li	44
活血止痛膏	huo xue zhi tong gao	14
甲硝唑芬布芬胶囊	jia xiao zuo fen bu fen jiao nang	18
康妇灵胶囊	kang fu ling jiao nang	45
克霉唑栓	ke mei zuo shuan	15
口腔溃疡散	kou qiang kui yang san	42
六味地黄胶囊	liu wei di huang jiao nang	43
龙珠软膏	long zhu ruan gao	46
氯雷他定片	lv lei ta ding pian	19
强力脑心康胶囊	qiang li nao xin kang jiao nang	11
舒秘胶囊	shu mi jiao nang	47
心可舒胶囊	xin ke shu jiao nang	20
炎热清颗粒	yan re qing ke li	17
注册名称	zhu ce ming cheng	48
