# 文件名：淮北市药品经营企业地址.scel
# 词库名：淮北市药品经营企业地址
# 词库分类：其它
# 词库描述：
# 词条样例：濉溪县开发区 淮北市惠黎路号北区 濉溪县古饶镇菜市街西 濉溪县马桥乡闸河路西 濉溪县钟楼乡张集街西段 淮北市相山区任圩镇任张路中段
# 词条数量：294

淮北海孜矿工人村	huai bei hai zi kuang gong ren cun	276
淮北惠黎菜市场北门沿街	huai bei hui li cai shi chang bei men yan jie	240
淮北烈山工人村	huai bei lie shan gong ren cun	203
淮北市百善矿商业街东段	huai bei shi bai shan kuang shang ye jie dong duan	156
淮北市长山北路	huai bei shi chang shan bei lu	154
淮北市翠峰路清荷园号	huai bei shi cui feng lu qing he yuan hao	195
淮北市岱河矿河东街	huai bei shi dai he kuang he dong jie	155
淮北市岱河矿美味宫超市对面	huai bei shi dai he kuang mei wei gong chao shi dui mian	179
淮北市东岗楼立交桥北米路西	huai bei shi dong gang lou li jiao qiao bei mi lu xi	279
淮北市杜集区岱河矿大门西侧	huai bei shi du ji qu dai he kuang da men xi ce	169
淮北市杜集区高岳镇岱河矿北街	huai bei shi du ji qu gao yue zhen dai he kuang bei jie	147
淮北市杜集区高岳镇李洼集	huai bei shi du ji qu gao yue zhen li wa ji	148
淮北市杜集区矿山集新华巷	huai bei shi du ji qu kuang shan ji xin hua xiang	173
淮北市杜集区矿山集镇菜市街	huai bei shi du ji qu kuang shan ji zhen cai shi jie	180
淮北市杜集区矿山集镇矿山集街	huai bei shi du ji qu kuang shan ji zhen kuang shan ji jie	150
淮北市杜集区矿山集镇路北村东	huai bei shi du ji qu kuang shan ji zhen lu bei cun dong	181
淮北市杜集区石台镇程台村	huai bei shi du ji qu shi tai zhen cheng tai cun	255
淮北市杜集区朔里镇汽车站	huai bei shi du ji qu shuo li zhen qi che zhan	273
淮北市杜集区朔里镇邮政局对面	huai bei shi du ji qu shuo li zhen you zheng ju dui mian	214
淮北市杜集区朔里镇纵楼商品街	huai bei shi du ji qu shuo li zhen zong lou shang pin jie	162
淮北市杜集区孙谢庄集	huai bei shi du ji qu sun xie zhuang ji	159
淮北市杜集区相杜路	huai bei shi du ji qu xiang du lu	292
淮北市杜集区相杜路幢号	huai bei shi du ji qu xiang du lu zhuang hao	172
淮北市杜集区袁庄矿工人村	huai bei shi du ji qu yuan zhuang kuang gong ren cun	178
淮北市杜集区朱庄矿	huai bei shi du ji qu zhu zhuang kuang	261
淮北市段园镇	huai bei shi duan yuan zhen	221
淮北市段园镇袁庄菜市场路东	huai bei shi duan yuan zhen yuan zhuang cai shi chang lu dong	151
淮北市纺织厂家属区	huai bei shi fang zhi chang jia shu qu	219
淮北市高岳路商运小区号楼	huai bei shi gao yue lu shang yun xiao qu hao lou	246
淮北市古城路	huai bei shi gu cheng lu	202
淮北市古城路号	huai bei shi gu cheng lu hao	272
淮北市古城路中段	huai bei shi gu cheng lu zhong duan	242
淮北市古城路中路	huai bei shi gu cheng lu zhong lu	234
淮北市古城西路号路南	huai bei shi gu cheng xi lu hao lu nan	225
淮北市海宫新村号楼商品营业房	huai bei shi hai gong xin cun hao lou shang pin ying ye fang	284
淮北市海孜矿工人村菜市场对面	huai bei shi hai zi kuang gong ren cun cai shi chang dui mian	160
淮北市海孜矿商品街房	huai bei shi hai zi kuang shang pin jie fang	186
淮北市洪山路北面号	huai bei shi hong shan lu bei mian hao	194
淮北市洪山路号	huai bei shi hong shan lu hao	248
淮北市淮纺路西段	huai bei shi huai fang lu xi duan	277
淮北市淮海路号	huai bei shi huai hai lu hao	241
淮北市惠黎路号	huai bei shi hui li lu hao	285
淮北市惠黎路号北区	huai bei shi hui li lu hao bei qu	288
淮北市惠黎新村步行街号门面房	huai bei shi hui li xin cun bu xing jie hao men mian fang	252
淮北市级经济开发龙湖工业园	huai bei shi ji jing ji kai fa long hu gong ye yuan	289
淮北市交通局大厦一楼	huai bei shi jiao tong ju da sha yi lou	251
淮北市矿山集大街地税局楼下	huai bei shi kuang shan ji da jie di shui ju lou xia	227
淮北市矿山集湖滨路	huai bei shi kuang shan ji hu bin lu	149
淮北市矿山集中心村	huai bei shi kuang shan ji zhong xin cun	275
淮北市利民巷号	huai bei shi li min xiang hao	200
淮北市利民巷中段	huai bei shi li min xiang zhong duan	153
淮北市黎苑新村二期组号门面	huai bei shi li yuan xin cun er qi zu hao men mian	220
淮北市烈山工人村	huai bei shi lie shan gong ren cun	237
淮北市烈山工人村东头	huai bei shi lie shan gong ren cun dong tou	249
淮北市烈山工人村四村二幢室	huai bei shi lie shan gong ren cun si cun er zhuang shi	193
淮北市烈山区烈山镇淮宿路路南	huai bei shi lie shan qu lie shan zhen huai su lu lu nan	254
淮北市烈山区临涣步行街	huai bei shi lie shan qu lin huan bu xing jie	259
淮北市烈山区七矿西粮站门面楼	huai bei shi lie shan qu qi kuang xi liang zhan men mian lou	247
淮北市烈山区望阳路中段	huai bei shi lie shan qu wang yang lu zhong duan	283
淮北市烈山区新蔡镇蔡里集	huai bei shi lie shan qu xin cai zhen cai li ji	171
淮北市烈山区新蔡镇蔡里街	huai bei shi lie shan qu xin cai zhen cai li jie	253
淮北市烈山区杨庄矿工人村	huai bei shi lie shan qu yang zhuang kuang gong ren cun	258
淮北市烈山镇马场街	huai bei shi lie shan zhen ma chang jie	266
淮北市临涣矿工人村	huai bei shi lin huan kuang gong ren cun	268
淮北市煤师院院内	huai bei shi mei shi yuan yuan nei	228
淮北市民生路二幼对面	huai bei shi min sheng lu er you dui mian	218
淮北市渠沟镇老街电校对面西	huai bei shi qu gou zhen lao jie dian xiao dui mian xi	196
淮北市渠沟镇土楼街	huai bei shi qu gou zhen tu lou jie	174
淮北市人民路董庄村号	huai bei shi ren min lu dong zhuang cun hao	267
淮北市任圩镇综合市场西米	huai bei shi ren xu zhen zong he shi chang xi mi	167
淮北市沈庄矿绿源公司门西	huai bei shi shen zhuang kuang lv yuan gong si men xi	191
淮北市石台镇商品街	huai bei shi shi tai zhen shang pin jie	161
淮北市朔里百惠公司服装厂楼下	huai bei shi shuo li bai hui gong si fu zhuang chang lou xia	175
淮北市朔里矿中路东头路东	huai bei shi shuo li kuang zhong lu dong tou lu dong	215
淮北市朔里镇店子集	huai bei shi shuo li zhen dian zi ji	177
淮北市朔里镇纵楼大市场	huai bei shi shuo li zhen zong lou da shi chang	168
淮北市四海花园小区栋门面房	huai bei shi si hai hua yuan xiao qu dong men mian fang	269
淮北市特凿公司东山菜市场	huai bei shi te zao gong si dong shan cai shi chang	199
淮北市相城矿工人村	huai bei shi xiang cheng kuang gong ren cun	238
淮北市相山南路黎苑小区号	huai bei shi xiang shan nan lu li yuan xiao qu hao	158
淮北市相山区长山路东	huai bei shi xiang shan qu chang shan lu dong	157
淮北市相山区长山路号	huai bei shi xiang shan qu chang shan lu hao	263
淮北市相山区长山中路号	huai bei shi xiang shan qu chang shan zhong lu hao	198
淮北市相山区东岗楼	huai bei shi xiang shan qu dong gang lou	262
淮北市相山区古城东路	huai bei shi xiang shan qu gu cheng dong lu	264
淮北市相山区海宫路	huai bei shi xiang shan qu hai gong lu	243
淮北市相山区海宫路号	huai bei shi xiang shan qu hai gong lu hao	233
淮北市相山区花园新村栋号门面	huai bei shi xiang shan qu hua yuan xin cun dong hao men mian	229
淮北市相山区淮海路北侧号	huai bei shi xiang shan qu huai hai lu bei ce hao	239
淮北市相山区淮海路幢一二层	huai bei shi xiang shan qu huai hai lu zhuang yi er ceng	207
淮北市相山区淮海西路号	huai bei shi xiang shan qu huai hai xi lu hao	209
淮北市相山区惠黎路	huai bei shi xiang shan qu hui li lu	231
淮北市相山区惠黎路号	huai bei shi xiang shan qu hui li lu hao	226
淮北市相山区建安路号	huai bei shi xiang shan qu jian an lu hao	208
淮北市相山区黎苑步行街	huai bei shi xiang shan qu li yuan bu xing jie	211
淮北市相山区黎苑路	huai bei shi xiang shan qu li yuan lu	217
淮北市相山区南黎路北长身路东	huai bei shi xiang shan qu nan li lu bei chang shen lu dong	294
淮北市相山区渠沟路号	huai bei shi xiang shan qu qu gou lu hao	236
淮北市相山区渠沟镇任土楼街	huai bei shi xiang shan qu qu gou zhen ren tu lou jie	166
淮北市相山区任圩派出所东米	huai bei shi xiang shan qu ren xu pai chu suo dong mi	176
淮北市相山区任圩镇任张路中段	huai bei shi xiang shan qu ren xu zhen ren zhang lu zhong duan	278
淮北市相山区濉溪路号	huai bei shi xiang shan qu sui xi lu hao	250
淮北市相山区濉溪中路	huai bei shi xiang shan qu sui xi zhong lu	222
淮北市相山区相山路	huai bei shi xiang shan qu xiang shan lu	204
淮北市相山区相山路东环保路南	huai bei shi xiang shan qu xiang shan lu dong huan bao lu nan	164
淮北市相山区相山路号	huai bei shi xiang shan qu xiang shan lu hao	223
淮北市相山区相山南路	huai bei shi xiang shan qu xiang shan nan lu	216
淮北市相山区相阳路	huai bei shi xiang shan qu xiang yang lu	235
淮北市相山区新华巷东侧商住楼	huai bei shi xiang shan qu xin hua xiang dong ce shang zhu lou	152
淮北市相山区鹰山北路号	huai bei shi xiang shan qu ying shan bei lu hao	224
淮北市相山区鹰山路号	huai bei shi xiang shan qu ying shan lu hao	163
淮北市相山区友谊巷	huai bei shi xiang shan qu you yi xiang	205
淮北市相山区闸河路	huai bei shi xiang shan qu zha he lu	265
淮北市相山区闸河路号	huai bei shi xiang shan qu zha he lu hao	210
淮北市相阳路段号	huai bei shi xiang yang lu duan hao	230
淮北市鹰山北路号	huai bei shi ying shan bei lu hao	206
淮北市鹰山路号	huai bei shi ying shan lu hao	232
淮北市鹰山路环卫处楼下	huai bei shi ying shan lu huan wei chu lou xia	213
淮北市闸河路号	huai bei shi zha he lu hao	271
淮北市闸河路汽车站东门南旁	huai bei shi zha he lu qi che zhan dong men nan pang	287
淮北市长山路号	huai bei shi zhang shan lu hao	244
淮北市长山路矿工医院门口路东	huai bei shi zhang shan lu kuang gong yi yuan men kou lu dong	245
淮北市长山路市政工程处右侧	huai bei shi zhang shan lu shi zheng gong cheng chu you ce	212
淮北市长山路四海绿洲花园	huai bei shi zhang shan lu si hai lv zhou hua yuan	197
淮北市长山路斜拉桥下	huai bei shi zhang shan lu xie la qiao xia	170
淮北市朱庄矿中心村幢号	huai bei shi zhu zhuang kuang zhong xin cun zhuang hao	256
淮海路号交通商厦对面	huai hai lu hao jiao tong shang sha dui mian	286
临涣矿工人村	lin huan kuang gong ren cun	260
刘桥矿工人村	liu qiao kuang gong ren cun	165
濉溪古饶镇大河集街中段	sui xi gu rao zhen da he ji jie zhong duan	188
濉溪孙疃菜市场	sui xi sun tuan cai shi chang	121
濉溪县白沙集	sui xi xian bai sha ji	76
濉溪县白沙乡白沙集	sui xi xian bai sha xiang bai sha ji	28
濉溪县白沙镇新街	sui xi xian bai sha zhen xin jie	26
濉溪县白沙镇袁店街	sui xi xian bai sha zhen yuan dian jie	60
濉溪县百善街	sui xi xian bai shan jie	43
濉溪县百善镇	sui xi xian bai shan zhen	73
濉溪县百善镇百善街	sui xi xian bai shan zhen bai shan jie	95
濉溪县百善镇百善街宿永路北米	sui xi xian bai shan zhen bai shan jie su yong lu bei mi	13
濉溪县百善镇宋庙街	sui xi xian bai shan zhen song miao jie	44
濉溪县百善镇宿永路北侧	sui xi xian bai shan zhen su yong lu bei ce	129
濉溪县陈集街	sui xi xian chen ji jie	117
濉溪县陈集乡陈集街	sui xi xian chen ji xiang chen ji jie	49
濉溪县陈集乡陈集镇	sui xi xian chen ji xiang chen ji zhen	48
濉溪县陈集乡罗集街	sui xi xian chen ji xiang luo ji jie	2
濉溪县陈集乡三和街	sui xi xian chen ji xiang san he jie	66
濉溪县东关	sui xi xian dong guan	146
濉溪县东关大桥头东	sui xi xian dong guan da qiao tou dong	112
濉溪县古饶镇	sui xi xian gu rao zhen	185
濉溪县古饶镇菜市街西	sui xi xian gu rao zhen cai shi jie xi	282
濉溪县古饶镇大河村贾家	sui xi xian gu rao zhen da he cun jia jia	192
濉溪县古饶镇双秦集桥南	sui xi xian gu rao zhen shuang qin ji qiao nan	190
濉溪县海孜街	sui xi xian hai zi jie	36
濉溪县韩村小湖集	sui xi xian han cun xiao hu ji	35
濉溪县韩村镇	sui xi xian han cun zhen	68
濉溪县韩村镇大庄村	sui xi xian han cun zhen da zhuang cun	32
濉溪县韩村镇韩村街友谊路	sui xi xian han cun zhen han cun jie you yi lu	120
濉溪县韩村镇淮六路西侧	sui xi xian han cun zhen huai liu lu xi ce	31
濉溪县韩村镇浍河街号	sui xi xian han cun zhen hui he jie hao	33
濉溪县韩村镇振兴街号	sui xi xian han cun zhen zhen xing jie hao	18
濉溪县虎山路	sui xi xian hu shan lu	111
濉溪县虎山路北段	sui xi xian hu shan lu bei duan	87
濉溪县虎山路粮油公司南米	sui xi xian hu shan lu liang you gong si nan mi	142
濉溪县虎山路南段	sui xi xian hu shan lu nan duan	123
濉溪县虎山路南段号	sui xi xian hu shan lu nan duan hao	108
濉溪县虎山路中段	sui xi xian hu shan lu zhong duan	91
濉溪县淮海路	sui xi xian huai hai lu	114
濉溪县淮海路北段	sui xi xian huai hai lu bei duan	126
濉溪县淮海路交警大队南米	sui xi xian huai hai lu jiao jing da dui nan mi	93
濉溪县淮海路南段	sui xi xian huai hai lu nan duan	90
濉溪县淮海路汽车站楼下	sui xi xian huai hai lu qi che zhan lou xia	96
濉溪县淮海路顺达商贸公司楼下	sui xi xian huai hai lu shun da shang mao gong si lou xia	4
濉溪县开发区	sui xi xian kai fa qu	291
濉溪县开发区刘庄村	sui xi xian kai fa qu liu zhuang cun	55
濉溪县老城后大街号	sui xi xian lao cheng hou da jie hao	94
濉溪县老城后大街中段	sui xi xian lao cheng hou da jie zhong duan	101
濉溪县烈山路北段	sui xi xian lie shan lu bei duan	92
濉溪县烈山路南段	sui xi xian lie shan lu nan duan	89
濉溪县烈山南路号	sui xi xian lie shan nan lu hao	77
濉溪县临涣集	sui xi xian lin huan ji	62
濉溪县临涣街临青路	sui xi xian lin huan jie lin qing lu	20
濉溪县临涣南阁街	sui xi xian lin huan nan ge jie	19
濉溪县临涣镇	sui xi xian lin huan zhen	29
濉溪县临涣镇淮海路东段	sui xi xian lin huan zhen huai hai lu dong duan	135
濉溪县临涣镇马周庄码头	sui xi xian lin huan zhen ma zhou zhuang ma tou	119
濉溪县临涣镇南阁街	sui xi xian lin huan zhen nan ge jie	3
濉溪县临涣镇新市村	sui xi xian lin huan zhen xin shi cun	58
濉溪县临涣镇永红村	sui xi xian lin huan zhen yong hong cun	56
濉溪县临涣镇中心街	sui xi xian lin huan zhen zhong xin jie	59
濉溪县临涣中学对面	sui xi xian lin huan zhong xue dui mian	78
濉溪县刘桥镇	sui xi xian liu qiao zhen	124
濉溪县刘桥镇陈集村	sui xi xian liu qiao zhen chen ji cun	23
濉溪县刘桥镇刘桥矿工人村	sui xi xian liu qiao zhen liu qiao kuang gong ren cun	134
濉溪县刘桥镇刘桥行政村	sui xi xian liu qiao zhen liu qiao xing zheng cun	8
濉溪县马桥乡闸河路西	sui xi xian ma qiao xiang zha he lu xi	281
濉溪县南坪任集矿北街	sui xi xian nan ping ren ji kuang bei jie	1
濉溪县南坪镇花园街号	sui xi xian nan ping zhen hua yuan jie hao	145
濉溪县南坪镇绘坪东街号	sui xi xian nan ping zhen hui ping dong jie hao	51
濉溪县南坪镇绘坪街北	sui xi xian nan ping zhen hui ping jie bei	50
濉溪县南坪镇南坪街	sui xi xian nan ping zhen nan ping jie	53
濉溪县祁集镇海孜街东头	sui xi xian qi ji zhen hai zi jie dong tou	137
濉溪县祁集镇海孜街西侧北路	sui xi xian qi ji zhen hai zi jie xi ce bei lu	138
濉溪县祁集镇祁集街	sui xi xian qi ji zhen qi ji jie	41
濉溪县祁集镇小徐庄	sui xi xian qi ji zhen xiao xu zhuang	133
濉溪县任集街北段	sui xi xian ren ji jie bei duan	139
濉溪县任集镇矿北街	sui xi xian ren ji zhen kuang bei jie	40
濉溪县任集镇任集街	sui xi xian ren ji zhen ren ji jie	65
濉溪县三堤口	sui xi xian san di kou	290
濉溪县三堤口批发市场	sui xi xian san di kou pi fa shi chang	86
濉溪县实验小学对面	sui xi xian shi yan xiao xue dui mian	122
濉溪县双堆集解放路	sui xi xian shuang dui ji jie fang lu	14
濉溪县双堆集镇解放路	sui xi xian shuang dui ji zhen jie fang lu	131
濉溪县双堆集镇双堆街	sui xi xian shuang dui ji zhen shuang dui jie	61
濉溪县双堆集镇双堆街淮海路号	sui xi xian shuang dui ji zhen shuang dui jie huai hai lu hao	103
濉溪县双堆街	sui xi xian shuang dui jie	64
濉溪县双堆芦沟街	sui xi xian shuang dui lu gou jie	21
濉溪县四卜集	sui xi xian si bu ji	63
濉溪县四卜乡三铺街	sui xi xian si bu xiang san pu jie	39
濉溪县四卜镇	sui xi xian si bu zhen	71
濉溪县四铺街	sui xi xian si pu jie	143
濉溪县四铺乡大曹农贸街	sui xi xian si pu xiang da cao nong mao jie	5
濉溪县四铺乡四铺集桥东	sui xi xian si pu xiang si pu ji qiao dong	144
濉溪县四铺乡四铺街菜市南米	sui xi xian si pu xiang si pu jie cai shi nan mi	72
濉溪县四铺乡四铺街大桥南米	sui xi xian si pu xiang si pu jie da qiao nan mi	11
濉溪县濉海路号	sui xi xian sui hai lu hao	109
濉溪县濉河路东段	sui xi xian sui he lu dong duan	88
濉溪县濉河路号	sui xi xian sui he lu hao	293
濉溪县濉溪镇蒙村街	sui xi xian sui xi zhen meng cun jie	85
濉溪县濉溪镇石南路号	sui xi xian sui xi zhen shi nan lu hao	107
濉溪县濉溪镇溪河路县医院对面	sui xi xian sui xi zhen xi he lu xian yi yuan dui mian	7
濉溪县濉溪镇仲家巷号	sui xi xian sui xi zhen zhong jia xiang hao	9
濉溪县孙町郭集街街西	sui xi xian sun ding guo ji jie jie xi	47
濉溪县孙町街	sui xi xian sun ding jie	67
濉溪县孙町镇龙沟商业街	sui xi xian sun ding zhen long gou shang ye jie	46
濉溪县孙町镇孙町街	sui xi xian sun ding zhen sun ding jie	45
濉溪县孙町镇孙町中学大门东	sui xi xian sun ding zhen sun ding zhong xue da men dong	128
濉溪县孙町镇王庄西头路北	sui xi xian sun ding zhen wang zhuang xi tou lu bei	81
濉溪县孙町中心街孙町中学对面	sui xi xian sun ding zhong xin jie sun ding zhong xue dui mian	12
濉溪县铁佛街	sui xi xian tie fo jie	24
濉溪县铁佛镇店孜村店孜街中段	sui xi xian tie fo zhen dian zi cun dian zi jie zhong duan	130
濉溪县铁佛镇店孜街	sui xi xian tie fo zhen dian zi jie	132
濉溪县铁佛镇留古集	sui xi xian tie fo zhen liu gu ji	25
濉溪县铁佛镇铁佛街	sui xi xian tie fo zhen tie fo jie	82
濉溪县沱和河路东段	sui xi xian tuo he he lu dong duan	84
濉溪县沱河路广播局前门面	sui xi xian tuo he lu guang bo ju qian men mian	98
濉溪县沱河路号	sui xi xian tuo he lu hao	97
濉溪县沱河路六小西侧	sui xi xian tuo he lu liu xiao xi ce	80
濉溪县五沟街号	sui xi xian wu gou jie hao	116
濉溪县五沟镇	sui xi xian wu gou zhen	74
濉溪县五沟镇白沙街中心	sui xi xian wu gou zhen bai sha jie zhong xin	16
濉溪县五沟镇步行街	sui xi xian wu gou zhen bu xing jie	17
濉溪县五沟镇大陈集	sui xi xian wu gou zhen da chen ji	37
濉溪县五沟镇大陈集赵庄街东段	sui xi xian wu gou zhen da chen ji zhao zhuang jie dong duan	22
濉溪县五沟镇童亭集	sui xi xian wu gou zhen tong ting ji	30
濉溪县五沟镇五沟集河南街	sui xi xian wu gou zhen wu gou ji he nan jie	57
濉溪县五沟镇五沟新街	sui xi xian wu gou zhen wu gou xin jie	27
濉溪县五里郢	sui xi xian wu li ying	100
濉溪县五铺街	sui xi xian wu pu jie	141
濉溪县五铺乡菜市街中段	sui xi xian wu pu xiang cai shi jie zhong duan	52
濉溪县五铺乡魏集	sui xi xian wu pu xiang wei ji	136
濉溪县五铺乡魏集街	sui xi xian wu pu xiang wei ji jie	140
濉溪县五铺乡五铺街南	sui xi xian wu pu xiang wu pu jie nan	38
濉溪县溪河路	sui xi xian xi he lu	104
濉溪县溪河路号	sui xi xian xi he lu hao	115
濉溪县溪河路西段	sui xi xian xi he lu xi duan	105
濉溪县溪河路中段	sui xi xian xi he lu zhong duan	125
濉溪县溪河派出所西段虎山路号	sui xi xian xi he pai chu suo xi duan hu shan lu hao	79
濉溪县溪河中段号	sui xi xian xi he zhong duan hao	102
濉溪县小湖孜街	sui xi xian xiao hu zi jie	34
濉溪县新城淮海南路	sui xi xian xin cheng huai hai nan lu	106
濉溪县新城溪河路号	sui xi xian xin cheng xi he lu hao	99
濉溪县新城溪河路西段路北	sui xi xian xin cheng xi he lu xi duan lu bei	110
濉溪县徐楼镇丁楼村程楼	sui xi xian xu lou zhen ding lou cun cheng lou	6
濉溪县徐楼镇龙桥集	sui xi xian xu lou zhen long qiao ji	69
濉溪县徐楼镇徐楼街	sui xi xian xu lou zhen xu lou jie	15
濉溪县杨柳街	sui xi xian yang liu jie	75
濉溪县杨柳乡陈楼街路西	sui xi xian yang liu xiang chen lou jie lu xi	54
濉溪县杨柳乡杨柳街	sui xi xian yang liu xiang yang liu jie	118
濉溪县岳集乡卧龙矿对面	sui xi xian yue ji xiang wo long kuang dui mian	10
濉溪县岳集乡岳集街	sui xi xian yue ji xiang yue ji jie	42
濉溪县岳集乡岳集街濉岳路东	sui xi xian yue ji xiang yue ji jie sui yue lu dong	83
濉溪县岳集乡岳集街西段	sui xi xian yue ji xiang yue ji jie xi duan	70
濉溪县闸河路号	sui xi xian zha he lu hao	113
濉溪县赵集街	sui xi xian zhao ji jie	201
濉溪县赵集平山街中心	sui xi xian zhao ji ping shan jie zhong xin	183
濉溪县赵集乡平山街	sui xi xian zhao ji xiang ping shan jie	187
濉溪县赵集乡赵集街	sui xi xian zhao ji xiang zhao ji jie	182
濉溪县赵集乡赵集街北段	sui xi xian zhao ji xiang zhao ji jie bei duan	184
濉溪县钟楼乡何庄	sui xi xian zhong lou xiang he zhuang	257
濉溪县钟楼乡张集街南段	sui xi xian zhong lou xiang zhang ji jie nan duan	274
濉溪县钟楼乡张集街西段	sui xi xian zhong lou xiang zhang ji jie xi duan	280
濉溪县钟楼乡钟楼街	sui xi xian zhong lou xiang zhong lou jie	189
濉溪镇三堤口	sui xi zhen san di kou	127
童亭矿工人村	tong ting kuang gong ren cun	270
