# 文件名：疫苗【官方推荐】.scel
# 词库名：疫苗【官方推荐】
# 词库分类：其它
# 词库描述：
# 词条样例：黄热疫苗 霍乱疫苗 甲肝疫苗 甲流疫苗 百白破疫苗 布病疫苗
# 词条数量：123

百白破	bai bai po	117
百白破联合疫苗	bai bai po lian he yi miao	80
百白破疫苗	bai bai po yi miao	110
白喉抗毒素	bai hou kang du su	11
白破	bai po	38
白破疫苗	bai po yi miao	109
布病疫苗	bu bing yi miao	107
肠道病毒疫苗	chang dao bing du yi miao	106
重组乙型肝炎疫苗	chong zu yi xing gan yan yi miao	69
冻干白喉抗毒素	dong gan bai hou kang du su	10
冻干甲型肝炎减毒活疫苗	dong gan jia xing gan yan jian du huo yi miao	51
冻干狂犬病人免疫球蛋白	dong gan kuang quan bing ren mian yi qiu dan bai	4
冻干破伤风抗毒素	dong gan po shang feng kang du su	8
冻干破伤风人免疫球蛋白	dong gan po shang feng ren mian yi qiu dan bai	7
冻干人用狂犬病疫苗	dong gan ren yong kuang quan bing yi miao	65
冻干水痘减毒活疫苗	dong gan shui dou jian du huo yi miao	53
冻干乙型肝炎人免疫球蛋白	dong gan yi xing gan yan ren mian yi qiu dan bai	12
多肽疫苗	duo tai yi miao	74
肺炎球菌多糖结合疫苗	fei yan qiu jun duo tang jie he yi miao	59
肺炎疫苗	fei yan yi miao	83
风疹	feng zhen	33
风疹减毒活疫苗	feng zhen jian du huo yi miao	34
风疹疫苗	feng zhen yi miao	105
钩端螺旋体疫苗	gou duan luo xuan ti yi miao	104
国产疫苗	guo chan yi miao	122
汉逊酵母	han xun jiao mu	67
核酸疫苗	he suan yi miao	72
猴肾细胞	hou shen xi bao	44
黄热疫苗	huang re yi miao	115
霍乱疫苗	huo luan yi miao	114
脊灰	ji hui	46
脊灰疫苗	ji hui yi miao	113
脊髓灰质炎减毒活疫苗	ji sui hui zhi yan jian du huo yi miao	47
脊髓灰质炎灭活疫苗	ji sui hui zhi yan mie huo yi miao	42
甲肝乙肝联合疫苗	jia gan yi gan lian he yi miao	25
甲肝疫苗	jia gan yi miao	112
甲流疫苗	jia liu yi miao	111
甲型肝炎减毒活疫苗	jia xing gan yan jian du huo yi miao	26
甲型肝炎灭活疫苗	jia xing gan yan mie huo yi miao	62
甲型乙型肝炎联合疫苗	jia xing yi xing gan yan lian he yi miao	60
甲乙联合疫苗	jia yi lian he yi miao	103
减毒二倍体	jian du er bei ti	45
减毒猴肾	jian du hou shen	43
减毒活疫苗	jian du huo yi miao	78
酵母	jiao mu	48
结核菌素纯蛋白衍生物	jie he jun su chun dan bai yan sheng wu	3
进口疫苗	jin kou yi miao	121
卡介菌纯蛋白衍生物	ka jie jun chun dan bai yan sheng wu	2
卡介苗	ka jie miao	102
抗狂犬病血清	kang kuang quan bing xue qing	6
可食用的疫苗	ke shi yong de yi miao	71
口服福氏宋内痢疾双价活疫苗	kou fu fu shi song nei li ji shuang jia huo yi miao	16
口服轮状病毒活疫苗	kou fu lun zhuang bing du huo yi miao	57
狂犬病人免疫球蛋白	kuang quan bing ren mian yi qiu dan bai	5
兰菌净	lan jun jing	19
兰菌净细菌溶解物	lan jun jing xi jun rong jie wu	20
类毒素疫苗	lei du su yi miao	76
联合疫苗	lian he yi miao	118
流感病毒裂解疫苗	liu gan bing du lie jie yi miao	63
流感嗜血杆菌结合疫苗	liu gan shi xue gan jun jie he yi miao	70
流感疫苗	liu gan yi miao	101
流脑疫苗	liu nao yi miao	81
流行性感冒裂解疫苗	liu xing xing gan mao lie jie yi miao	23
流行性感冒全病毒灭活疫苗	liu xing xing gan mao quan bing du mie huo yi miao	24
流行性感冒亚单位疫苗	liu xing xing gan mao ya dan wei yi miao	22
轮状病毒	lun zhuang bing du	21
轮状病毒疫苗	lun zhuang bing du yi miao	100
麻风二联疫苗	ma feng er lian yi miao	99
麻腮二联疫苗	ma sai er lian yi miao	98
麻腮风三联疫苗	ma sai feng san lian yi miao	97
麻疹风疹联合减毒活疫苗	ma zhen feng zhen lian he jian du huo yi miao	54
麻疹减毒活疫苗	ma zhen jian du huo yi miao	36
麻疹腮腺炎风疹联合减毒活疫苗	ma zhen sai xian yan feng zhen lian he jian du huo yi miao	32
麻疹腮腺炎联合减毒活疫苗	ma zhen sai xian yan lian he jian du huo yi miao	31
麻疹疫苗	ma zhen yi miao	96
灭活疫苗	mie huo yi miao	77
脑膜炎球菌多糖疫苗	nao mo yan qiu jun duo tang yi miao	29
酿酒酵母	niang jiu jiao mu	68
皮肤划痕人用布氏菌活疫苗	pi fu hua hen ren yong bu shi jun huo yi miao	13
皮肤划痕人用炭疽活疫苗	pi fu hua hen ren yong tan ju huo yi miao	14
皮肤划痕用鼠疫活疫苗	pi fu hua hen yong shu yi huo yi miao	15
皮内注射用卡	pi nei zhu she yong ka	50
破伤风抗毒素	po shang feng kang du su	9
破伤风人免疫球蛋白	po shang feng ren mian yi qiu dan bai	52
破伤风疫苗	po shang feng yi miao	108
气管炎疫苗	qi guan yan yi miao	95
群流脑疫苗	qun liu nao yi miao	82
人二倍体细胞	ren er bei ti xi bao	61
人用狂犬病疫苗	ren yong kuang quan bing yi miao	64
腮腺炎	sai xian yan	35
腮腺炎风疹联合减毒活疫苗	sai xian yan feng zhen lian he jian du huo yi miao	30
腮腺炎减毒活疫苗	sai xian yan jian du huo yi miao	55
腮腺炎疫苗	sai xian yan yi miao	94
森林脑炎灭火疫苗	sen lin nao yan mie huo yi miao	92
森林脑炎疫苗	sen lin nao yan yi miao	93
伤寒副伤寒甲联合疫苗	shang han fu shang han jia lian he yi miao	18
伤寒副伤寒甲乙联合疫苗	shang han fu shang han jia yi lian he yi miao	17
伤寒疫苗	shang han yi miao	116
肾病综合征出血热疫苗	shen bing zong he zheng chu xue re yi miao	91
鼠疫疫苗	shu yi yi miao	90
双价人乳头瘤病毒吸附疫苗	shuang jia ren ru tou liu bing du xi fu yi miao	58
水痘减毒活疫苗	shui dou jian du huo yi miao	123
水痘疫苗	shui dou yi miao	89
炭疽疫苗	tan ju yi miao	88
戊肝疫苗	wu gan yi miao	87
五联疫苗	wu lian yi miao	120
吸附百白破联合疫苗	xi fu bai bai po lian he yi miao	41
吸附白喉破伤风联合疫苗	xi fu bai hou po shang feng lian he yi miao	39
吸附白喉疫苗	xi fu bai hou yi miao	37
吸附百日咳白喉联合疫苗	xi fu bai ri ke bai hou lian he yi miao	40
吸附破伤风疫苗	xi fu po shang feng yi miao	66
吸附无细胞百白破联合疫苗	xi fu wu xi bao bai bai po lian he yi miao	119
锡克试验毒素	xi ke shi yan du su	1
亚单位疫苗	ya dan wei yi miao	75
乙肝	yi gan	49
乙肝疫苗	yi gan yi miao	86
疫苗	yi miao	79
疫苗本	yi miao ben	56
乙脑疫苗	yi nao yi miao	85
乙型肝炎人免疫球蛋白	yi xing gan yan ren mian yi qiu dan bai	84
乙型脑炎减毒活疫苗	yi xing nao yan jian du huo yi miao	28
乙型脑炎灭活疫苗	yi xing nao yan mie huo yi miao	27
载体疫苗	zai ti yi miao	73
