# 文件名：腾讯电脑管家.scel
# 词库名：腾讯电脑管家
# 词库分类：软件
# 词库描述：
# 词条样例：管家安装产生很多垃圾 自动关联 登录内部错误 登录控件出错 开机时间慢 软件搬家
# 词条数量：16

长时间没有登录	chang shi jian mei you deng lu	5
登录控件出错	deng lu kong jian chu cuo	7
登录内部错误	deng lu nei bu cuo wu	8
钩子注入行为	gou zi zhu ru xing wei	15
管家安装产生很多垃圾	guan jia an zhuang chan sheng hen duo la ji	12
加速一直无法完成	jia su yi zhi wu fa wan cheng	6
开机禁用无效	kai ji jin yong wu xiao	2
开机时间慢	kai ji shi jian man	3
开机时间显示	kai ji shi jian xian shi	4
捆绑了管家	kun bang le guan jia	11
盘符无法安装管家	pan fu wu fa an zhuang guan jia	14
软件搬家	ruan jian ban jia	1
软件限制策略的阻止	ruan jian xian zhi ce lue de zu zhi	13
账号登录失败	zhang hao deng lu shi bai	9
自动关联	zi dong guan lian	10
阻止了一次注入行为	zu zhi le yi ci zhu ru xing wei	16
