# 文件名：地质学  名词解释.scel
# 词库名：地质学  名词解释
# 词库分类：地理地质
# 词库描述：
# 词条样例：各个应力状态的连线 剪应变 剪裂面与最大主应力的夹角 共轭剪裂角 均匀应变 非旋转变形
# 词条数量：44

不连续劈理	bu lian xu pi li	15
侧伏向与侧伏角	ce fu xiang yu ce fu jiao	42
单位面积的附加应力	dan wei mian ji de fu jia ying li	39
第二章	di er zhang	9
第三章	di san zhang	8
第四章	di si zhang	4
非共轴递进变形	fei gong zhou di jin bian xing	25
非均匀应变	fei jun yun ying bian	30
非透入性构造	fei tou ru xing gou zao	17
非旋转变形	fei xuan zhuan bian xing	27
各个应力状态的连线	ge ge ying li zhuang tai de lian xian	37
共轭剪裂角	gong e jian lie jiao	32
共轴递进变形	gong zhou di jin bian xing	26
构造盆地岩层从四周向中心倾斜	gou zao pen di yan ceng cong si zhou xiang zhong xin qing xie	3
剪节理由剪应力作用形成的节理	jian jie li you jian ying li zuo yong xing cheng de jie li	2
剪裂角	jian lie jiao	34
剪裂面与最大主应力的夹角	jian lie mian yu zui da zhu ying li de jia jiao	33
剪应变	jian ying bian	35
剪应变内角度的变化量	jian ying bian nei jiao du de bian hua liang	5
交面线理	jiao mian xian li	13
均匀应变	jun yun ying bian	31
矿物生长线理	kuang wu sheng zhang xian li	11
拉伸线理	la shen xian li	14
连续劈理	lian xu pi li	16
劈理	pi li	21
劈理域	pi li yu	20
倾伏向与倾伏角	qing fu xiang yu qing fu jiao	41
蠕变	ru bian	22
视倾角	shi qing jiao	44
石香肠构造	shi xiang chang gou zao	10
透入性构造	tou ru xing gou zao	18
微劈石	wei pi shi	19
线应变	xian ying bian	36
旋转变形	xuan zhuan bian xing	28
应变椭球体	ying bian tuo qiu ti	29
应变物体变形程度的量度	ying bian wu ti bian xing cheng du de liang du	6
应力	ying li	40
应力单位面积上附加内力称应力	ying li dan wei mian ji shang fu jia nei li cheng ying li	7
应力轨迹	ying li gui ji	38
有限应变	you xian ying bian	23
增量应变	zeng liang ying bian	24
张节理由张应力作用形成的节理	zhang jie li you zhang ying li zuo yong xing cheng de jie li	1
真倾角	zhen qing jiao	43
皱纹线理	zhou wen xian li	12
