# 文件名：苦苣苔科植物词库.scel
# 词库名：苦苣苔科植物词库
# 词库分类：植物
# 词库描述：
# 词条样例：芥状报春苣苔 肉叶报春苣苔 心叶报春苣苔 十字报春苣苔 多花报春苣苔 滇川报春苣苔
# 词条数量：66

薄叶报春苣苔	bo ye bao chun ju tai	8
长毛报春苣苔	chang mao bao chun ju tai	2
长柱报春苣苔	chang zhu bao chun ju tai	34
翅柄报春苣苔	chi bing bao chun ju tai	21
齿萼报春苣苔	chi e bao chun ju tai	4
刺齿报春苣苔	ci chi bao chun ju tai	12
大齿报春苣苔	da chi bao chun ju tai	45
滇川报春苣苔	dian chuan bao chun ju tai	50
短毛报春苣苔	duan mao bao chun ju tai	63
短头报春苣苔	duan tou bao chun ju tai	64
短序报春苣苔	duan xu bao chun ju tai	57
钝齿报春苣苔	dun chi bao chun ju tai	29
多花报春苣苔	duo hua bao chun ju tai	52
多葶报春苣苔	duo ting bao chun ju tai	23
二色报春苣苔	er se bao chun ju tai	65
方氏报春苣苔	fang shi bao chun ju tai	55
肥牛草	fei niu cao	47
粉花报春苣苔	fen hua bao chun ju tai	20
复叶报春苣苔	fu ye bao chun ju tai	25
岗报春苣苔	gang bao chun ju tai	36
光叶报春苣苔	guang ye bao chun ju tai	42
桂林报春苣苔	gui lin bao chun ju tai	48
桂粤报春苣苔	gui yue bao chun ju tai	51
黄斑报春苣苔	huang ban bao chun ju tai	53
芥状报春苣苔	jie zhuang bao chun ju tai	62
康定报春苣苔	kang ding bao chun ju tai	6
来凤报春苣苔	lai feng bao chun ju tai	44
荔波报春苣苔	li bo bao chun ju tai	41
连县报春苣苔	lian xian bao chun ju tai	40
零陵报春苣苔	ling ling bao chun ju tai	37
菱叶报春苣苔	ling ye bao chun ju tai	11
弄岗报春苣苔	long gang bao chun ju tai	35
隆林报春苣苔	long lin bao chun ju tai	33
龙州报春苣苔	long zhou bao chun ju tai	32
卵圆报春苣苔	luan yuan bao chun ju tai	19
蚂蝗七	ma huang qi	54
牛耳朵	niu er duo	56
清镇报春苣苔	qing zhen bao chun ju tai	17
肉叶报春苣苔	rou ye bao chun ju tai	60
三苞报春苣苔	san bao bao chun ju tai	5
少毛报春苣苔	shao mao bao chun ju tai	49
舌柱报春苣苔	she zhu bao chun ju tai	39
神农架报春苣苔	shen nong jia bao chun ju tai	7
十字报春苣苔	shi zi bao chun ju tai	58
疏花报春苣苔	shu hua bao chun ju tai	43
四川报春苣苔	si chuan bao chun ju tai	16
碎米荠叶报春苣苔	sui mi ji ye bao chun ju tai	61
条叶报春苣苔	tiao ye bao chun ju tai	28
微斑报春苣苔	wei ban bao chun ju tai	30
细筒报春苣苔	xi tong bao chun ju tai	3
线叶报春苣苔	xian ye bao chun ju tai	38
小报春苣苔	xiao bao chun ju tai	13
小叶报春苣苔	xiao ye bao chun ju tai	26
心叶报春苣苔	xin ye bao chun ju tai	59
焰苞报春苣苔	yan bao bao chun ju tai	14
烟叶报春苣苔	yan ye bao chun ju tai	46
药用报春苣苔	yao yong bao chun ju tai	31
硬叶报春苣苔	ying ye bao chun ju tai	18
永福报春苣苔	yong fu bao chun ju tai	1
羽裂报春苣苔	yu lie bao chun ju tai	24
直蕊报春苣苔	zhi rui bao chun ju tai	27
钟冠报春苣苔	zhong guan bao chun ju tai	9
中华报春苣苔	zhong hua bao chun ju tai	15
紫萼报春苣苔	zi e bao chun ju tai	66
紫纹报春苣苔	zi wen bao chun ju tai	22
钻萼报春苣苔	zuan e bao chun ju tai	10
