# 文件名：企业会计准则.scel
# 词库名：企业会计准则
# 词库分类：财务会计
# 词库描述：
# 词条样例：库存现金 银行存款基本存款账户 其他货币资金 其他货币资金信用证保证金 其他货币资金存出投资款 预付账款
# 词条数量：200

被套期项目	bei tao qi xiang mu	68
本年利润	ben nian li run	54
材料采购	cai liao cai gou	178
材料成本差异	cai liao cheng ben cha yi	175
财务费用	cai wu fei yong	20
长期待摊费用	chang qi dai tan fei yong	130
长期股权投资	chang qi gu quan tou zi	149
长期股权投资减值准备	chang qi gu quan tou zi jian zhi zhun bei	146
长期股权投资损益调整	chang qi gu quan tou zi sun yi tiao zheng	147
长期股权投资投资成本	chang qi gu quan tou zi tou zi cheng ben	148
长期借款	chang qi jie kuan	79
长期借款本金	chang qi jie kuan ben jin	78
长期借款利息调整	chang qi jie kuan li xi tiao zheng	77
长期应付款	chang qi ying fu kuan	75
长期应收款	chang qi ying shou kuan	142
持有待售负债	chi you dai shou fu zhai	82
持有待售资产	chi you dai shou zi chan	162
持有待售资产减值准备	chi you dai shou zi chan jian zhi zhun bei	161
存货跌价准备	cun huo die jia zhun bei	169
待处理财产损溢	dai chu li cai chan sun yi	128
递延收益	di yan shou yi	80
递延所得税负债	di yan suo de shui fu zhai	71
递延所得税资产	di yan suo de shui zi chan	129
短期借款	duan qi jie kuan	127
发出商品	fa chu shang pin	173
费用化支出	fei yong hua zhi chu	34
工程物资	gong cheng wu zi	136
公允价值变动损益	gong yun jia zhi bian dong sun yi	30
股本	gu ben	62
固定资产	gu ding zi chan	140
固定资产减值准备	gu ding zi chan jian zhi zhun bei	138
固定资产清理	gu ding zi chan qing li	135
管理费用	guan li fei yong	21
合同负债	he tong fu zhai	120
合同履约成本	he tong lv yue cheng ben	166
合同履约成本减值准备	he tong lv yue cheng ben jian zhi zhun bei	165
合同取得成本	he tong qu de cheng ben	164
合同取得成本减值准备	he tong qu de cheng ben jian zhi zhun bei	163
合同资产	he tong zi chan	168
合同资产减值准备	he tong zi chan jian zhi zhun bei	167
坏账准备	huai zhang zhun bei	180
交易性金融负债	jiao yi xing jin rong fu zhai	126
交易性金融负债本金	jiao yi xing jin rong fu zhai ben jin	125
交易性金融负债公允价值变动	jiao yi xing jin rong fu zhai gong yun jia zhi bian dong	124
交易性金融资产	jiao yi xing jin rong zi chan	189
交易性金融资产本金	jiao yi xing jin rong zi chan ben jin	188
交易性金融资产公允价值变动	jiao yi xing jin rong zi chan gong yun jia zhi bian dong	187
库存股	ku cun gu	44
库存商品	ku cun shang pin	174
库存现金	ku cun xian jin	200
劳务成本	lao wu cheng ben	36
累计摊销	lei ji tan xiao	133
累计折旧	lei ji zhe jiu	139
利润分配	li run fen pei	53
利润分配提取储备基金	li run fen pei ti qu chu bei ji jin	46
利润分配提取法定盈余公积	li run fen pei ti qu fa ding ying yu gong ji	52
利润分配提取企业发展基金	li run fen pei ti qu qi ye fa zhan ji jin	45
利润分配提取任意盈余公积	li run fen pei ti qu ren yi ying yu gong ji	51
利润分配未分配利润	li run fen pei wei fen pei li run	47
利润分配应付现金股利或利润	li run fen pei ying fu xian jin gu li huo li run	50
利润分配盈余公积补亏	li run fen pei ying yu gong ji bu kui	48
利润分配转作股本的利润	li run fen pei zhuan zuo gu ben de li run	49
其他货币资金	qi ta huo bi zi jin	196
其他货币资金存出投资款	qi ta huo bi zi jin cun chu tou zi kuan	190
其他货币资金外埠存款	qi ta huo bi zi jin wai bu cun kuan	195
其他货币资金信用卡	qi ta huo bi zi jin xin yong ka	192
其他货币资金信用证保证金	qi ta huo bi zi jin xin yong zheng bao zheng jin	191
其他货币资金银行本票	qi ta huo bi zi jin yin hang ben piao	193
其他货币资金银行汇票	qi ta huo bi zi jin yin hang hui piao	194
其他权益工具	qi ta quan yi gong ju	42
其他权益工具其他	qi ta quan yi gong ju qi ta	39
其他权益工具投资	qi ta quan yi gong ju tou zi	150
其他权益工具永续债	qi ta quan yi gong ju yong xu zhai	40
其他权益工具优先股	qi ta quan yi gong ju you xian gu	41
其他收益	qi ta shou yi	27
其他业务成本	qi ta ye wu cheng ben	24
其他业务收入	qi ta ye wu shou ru	31
其他应付款	qi ta ying fu kuan	83
其他应收款	qi ta ying shou kuan	181
其他债权投资	qi ta zhai quan tou zi	154
其他债权投资成本	qi ta zhai quan tou zi cheng ben	153
其他债权投资公允价值变动	qi ta zhai quan tou zi gong yun jia zhi bian dong	152
其他债权投资减值准备	qi ta zhai quan tou zi jian zhi zhun bei	151
其他综合收益	qi ta zong he shou yi	61
商品进销差价	shang pin jin xiao cha jia	172
商誉	shang yu	131
生产成本	sheng chan cheng ben	38
实收资本	shi shou zi ben	67
受托代销商品	shou tuo dai xiao shang pin	179
受托代销商品款	shou tuo dai xiao shang pin kuan	81
税金及附加	shui jin ji fu jia	23
所得税费用	suo de shui fei yong	17
套期工具	tao qi gong ju	69
投资收益	tou zi shou yi	29
投资性房地产	tou zi xing fang di chan	145
投资性房地产成本	tou zi xing fang di chan cheng ben	144
投资性房地产公允价值变动	tou zi xing fang di chan gong yun jia zhi bian dong	143
未确认融资费用	wei que ren rong zi fei yong	74
未实现融资收益	wei shi xian rong zi shou yi	141
委托加工物资	wei tuo jia gong wu zi	171
无形资产	wu xing zi chan	134
无形资产减值准备	wu xing zi chan jian zhi zhun bei	132
销售费用	xiao shou fei yong	22
研发支出	yan fa zhi chu	35
衍生工具	yan sheng gong ju	70
以前年度损益调整	yi qian nian du sun yi tiao zheng	16
以前年度损益调整财务费用	yi qian nian du sun yi tiao zheng cai wu fei yong	4
以前年度损益调整管理费用	yi qian nian du sun yi tiao zheng guan li fei yong	5
以前年度损益调整其他收益	yi qian nian du sun yi tiao zheng qi ta shou yi	11
以前年度损益调整其他业务成本	yi qian nian du sun yi tiao zheng qi ta ye wu cheng ben	8
以前年度损益调整其他业务收入	yi qian nian du sun yi tiao zheng qi ta ye wu shou ru	14
以前年度损益调整税金及附加	yi qian nian du sun yi tiao zheng shui jin ji fu jia	7
以前年度损益调整所得税费用	yi qian nian du sun yi tiao zheng suo de shui fei yong	1
以前年度损益调整投资收益	yi qian nian du sun yi tiao zheng tou zi shou yi	13
以前年度损益调整销售费用	yi qian nian du sun yi tiao zheng xiao shou fei yong	6
以前年度损益调整营业外收入	yi qian nian du sun yi tiao zheng ying ye wai shou ru	10
以前年度损益调整营业外支出	yi qian nian du sun yi tiao zheng ying ye wai zhi chu	2
以前年度损益调整主营业务成本	yi qian nian du sun yi tiao zheng zhu ying ye wu cheng ben	9
以前年度损益调整主营业务收入	yi qian nian du sun yi tiao zheng zhu ying ye wu shou ru	15
以前年度损益调整资产处置损益	yi qian nian du sun yi tiao zheng zi chan chu zhi sun yi	12
以前年度损益调整资产减值损失	yi qian nian du sun yi tiao zheng zi chan jian zhi sun shi	3
银行存款	yin hang cun kuan	199
银行存款基本存款账户	yin hang cun kuan ji ben cun kuan zhang hu	198
银行存款一般存款账户	yin hang cun kuan yi ban cun kuan zhang hu	197
应付股利	ying fu gu li	84
应付利息	ying fu li xi	85
应付票据	ying fu piao ju	123
应付债券	ying fu zhai quan	76
应付账款	ying fu zhang kuan	122
应付职工薪酬	ying fu zhi gong xin chou	119
应交税费	ying jiao shui fei	118
应交税费车船税	ying jiao shui fei che chuan shui	91
应交税费城市维护建设税	ying jiao shui fei cheng shi wei hu jian she shui	100
应交税费城镇土地使用税	ying jiao shui fei cheng zhen tu di shi yong shui	93
应交税费待抵扣进项税	ying jiao shui fei dai di kou jin xiang shui	105
应交税费代扣代交增值税	ying jiao shui fei dai kou dai jiao zeng zhi shui	88
应交税费待认证进项税	ying jiao shui fei dai ren zheng jin xiang shui	104
应交税费待转销项税额	ying jiao shui fei dai zhuan xiao xiang shui e	103
应交税费房产税	ying jiao shui fei fang chan shui	92
应交税费个人所得税	ying jiao shui fei ge ren suo de shui	96
应交税费简易计税	ying jiao shui fei jian yi ji shui	101
应交税费教育费附加	ying jiao shui fei jiao yu fei fu jia	99
应交税费矿产资源补偿费	ying jiao shui fei kuang chan zi yuan bu chang fei	90
应交税费排污费	ying jiao shui fei pai wu fei	89
应交税费企业所得税	ying jiao shui fei qi ye suo de shui	97
应交税费土地增值税	ying jiao shui fei tu di zeng zhi shui	94
应交税费未交增值税	ying jiao shui fei wei jiao zeng zhi shui	107
应交税费消费税	ying jiao shui fei xiao fei shui	98
应交税费应交城镇房产税	ying jiao shui fei ying jiao cheng zhen fang chan shui	87
应交税费应交环境保护税	ying jiao shui fei ying jiao huan jing bao hu shui	86
应交税费预交增值税	ying jiao shui fei yu jiao zeng zhi shui	106
应交税费增值税	ying jiao shui fei zeng zhi shui	117
应交税费增值税出口退税	ying jiao shui fei zeng zhi shui chu kou tui shui	113
应交税费增值税减免税款	ying jiao shui fei zeng zhi shui jian mian shui kuan	109
应交税费增值税进项税额	ying jiao shui fei zeng zhi shui jin xiang shui e	116
应交税费增值税进项税额转出	ying jiao shui fei zeng zhi shui jin xiang shui e zhuan chu	114
应交税费增值税留抵税额	ying jiao shui fei zeng zhi shui liu di shui e	102
应交税费增值税销项税额	ying jiao shui fei zeng zhi shui xiao xiang shui e	115
应交税费增值税销项税额抵减	ying jiao shui fei zeng zhi shui xiao xiang shui e di jian	110
应交税费增值税已交税金	ying jiao shui fei zeng zhi shui yi jiao shui jin	112
应交税费增值税转出多交增值税	ying jiao shui fei zeng zhi shui zhuan chu duo jiao zeng zhi shui	108
应交税费增值税转出未交增值税	ying jiao shui fei zeng zhi shui zhuan chu wei jiao zeng zhi shui	111
应交税费资源税	ying jiao shui fei zi yuan shui	95
应收股利	ying shou gu li	183
应收利息	ying shou li xi	182
应收票据	ying shou piao ju	186
应收退货成本	ying shou tui huo cheng ben	160
应收账款	ying shou zhang kuan	185
营业外收入	ying ye wai shou ru	26
营业外支出	ying ye wai zhi chu	18
盈余公积	ying yu gong ji	60
盈余公积储备基金	ying yu gong ji chu bei ji jin	57
盈余公积法定盈余公积	ying yu gong ji fa ding ying yu gong ji	59
盈余公积利润归还投资	ying yu gong ji li run gui huan tou zi	55
盈余公积企业发展基金	ying yu gong ji qi ye fa zhan ji jin	56
盈余公积任意盈余公积	ying yu gong ji ren yi ying yu gong ji	58
预付账款	yu fu zhang kuan	184
预计负债	yu ji fu zhai	72
预收账款	yu shou zhang kuan	121
原材料	yuan cai liao	176
在建工程	zai jian gong cheng	137
在途物资	zai tu wu zi	177
债权投资	zhai quan tou zi	159
债权投资减值准备	zhai quan tou zi jian zhi zhun bei	155
债权投资投资成本	zhai quan tou zi tou zi cheng ben	158
债权投资溢折价	zhai quan tou zi yi zhe jia	157
债权投资应计利息	zhai quan tou zi ying ji li xi	156
制造费用	zhi zao fei yong	37
周转材料	zhou zhuan cai liao	170
主营业务成本	zhu ying ye wu cheng ben	25
主营业务收入	zhu ying ye wu shou ru	32
专项储备	zhuan xiang chu bei	43
专项应付款	zhuan xiang ying fu kuan	73
资本公积	zi ben gong ji	66
资本公积股本溢价	zi ben gong ji gu ben yi jia	64
资本公积其他资本公积	zi ben gong ji qi ta zi ben gong ji	63
资本公积资本溢价	zi ben gong ji zi ben yi jia	65
资本化支出	zi ben hua zhi chu	33
资产处置损益	zi chan chu zhi sun yi	28
资产减值损失	zi chan jian zhi sun shi	19
