# 文件名：发展心理学名词.scel
# 词库名：发展心理学名词
# 词库分类：其他
# 词库描述：
# 词条样例：中学生思维的发展 中学生意志的发展 中学生想象的发展 小学儿童概念发展的培养 小学儿童性格的发展
# 词条数量：111

本能	ben neng	37
本能行为	ben neng xing wei	34
毕生发展	bi sheng fa zhan	8
不利环境下的语言发展	bu li huan jing xia de yu yan fa zhan	62
成年期	cheng nian qi	10
词汇量的发展	ci hui liang de fa zhan	59
定向与行走	ding xiang yu xing zou	47
动作发展	dong zuo fa zhan	49
儿童的创造力	er tong de chuang zao li	46
儿童的焦虑	er tong de jiao lv	73
儿童的恐惧	er tong de kong ju	68
儿童的劳动观念	er tong de lao dong guan nian	70
儿童的利他行为	er tong de li ta xing wei	71
儿童的自我中心与去自我中心	er tong de zi wo zhong xin yu qu zi wo zhong xin	66
儿童个性的形成与发展	er tong ge xing de xing cheng yu fa zhan	67
儿童个性评定量表	er tong ge xing ping ding liang biao	72
儿童绘画	er tong hui hua	60
儿童听觉障碍	er tong ting jue zhang ai	58
儿童心理发展的年龄阶段	er tong xin li fa zhan de nian ling jie duan	76
儿童言语发展理论	er tong yan yu fa zhan li lun	57
儿童语言测验量表	er tong yu yan ce yan liang biao	54
儿童智力测量表	er tong zhi li ce liang biao	64
发生认识论	fa sheng ren shi lun	25
发展心理学	fa zhan xin li xue	1
个别化教育计划	ge bie hua jiao yu ji hua	61
格赛尔的儿童心理学理论	ge sai er de er tong xin li xue li lun	24
个体发生	ge ti fa sheng	31
霍尔的心理发展理论	huo er de xin li fa zhan li lun	27
看话	kan hua	45
科尔伯格的道德发展理论	ke er bo ge de dao de fa zhan li lun	14
客体永久性	ke ti yong jiu xing	39
老年欺期	lao nian qi qi	2
盲童的记忆特点	mang tong de ji yi te dian	55
盲童的想象特点	mang tong de xiang xiang te dian	43
盲童的运动发展	mang tong de yun dong fa zhan	51
盲童听觉和语言发展	mang tong ting jue he yu yan fa zhan	48
皮亚杰的道德认知发展理论	pi ya jie de dao de ren zhi fa zhan li lun	19
青年期	qing nian qi	11
人的发展	ren de fa zhan	5
人的发展的基督教理论	ren de fa zhan de ji du jiao li lun	15
人的发展的人本主义理论	ren de fa zhan de ren ben zhu yi li lun	16
人的发展的神道理论	ren de fa zhan de shen dao li lun	21
人的发展的文化历史学说	ren de fa zhan de wen hua li shi xue shuo	26
人的发展的研究历史	ren de fa zhan de yan jiu li shi	6
人的发展的伊斯兰教理论	ren de fa zhan de yi si lan jiao li lun	22
人的发展的印度教理论	ren de fa zhan de yin du jiao li lun	29
人的发展的犹太教理论	ren de fa zhan de you tai jiao li lun	18
人的发展理论	ren de fa zhan li lun	28
人的发展与遗传学	ren de fa zhan yu yi chuan xue	38
认知发展	ren zhi fa zhan	53
认知发展中的记忆模式	ren zhi fa zhan zhong de ji yi mo shi	63
认知发展中的智慧模式	ren zhi fa zhan zhong de zhi hui mo shi	40
认知发展中的知觉模式	ren zhi fa zhan zhong de zhi jue mo shi	41
儒家关于人的发展学说	ru jia guan yu ren de fa zhan xue shuo	13
少年期	shao nian qi	7
身体意识	shen ti yi shi	50
生理成长	sheng li cheng zhang	33
失明的适应调整过程	shi ming de shi ying diao zheng guo cheng	56
守恒	shou heng	44
手语教学	shou yu jiao xue	52
特殊学校教学模式	te shu xue xiao jiao xue mo shi	42
童年期	tong nian qi	9
瓦龙的儿童心理学理论	wa long de er tong xin li xue li lun	12
小学儿童概念发展的培养	xiao xue er tong gai nian fa zhan de pei yang	105
小学儿童概念发展的特点	xiao xue er tong gai nian fa zhan de te dian	99
小学儿童概念获得的测定	xiao xue er tong gai nian huo de de ce ding	98
小学儿童观察力的培养	xiao xue er tong guan cha li de pei yang	96
小学儿童记忆的发展	xiao xue er tong ji yi de fa zhan	89
小学儿童解决问题的特点	xiao xue er tong jie jue wen ti de te dian	102
小学儿童理想的发展	xiao xue er tong li xiang de fa zhan	104
小学儿童练习的特点	xiao xue er tong lian xi de te dian	92
小学儿童品德的发展	xiao xue er tong pin de de fa zhan	94
小学儿童情感的发展	xiao xue er tong qing gan de fa zhan	90
小学儿童思维的发展	xiao xue er tong si wei de fa zhan	100
小学儿童想象的发展	xiao xue er tong xiang xiang de fa zhan	88
小学儿童心理发展的一般特点	xiao xue er tong xin li fa zhan de yi ban te dian	97
小学儿童性格的发展	xiao xue er tong xing ge de fa zhan	101
小学儿童学习动机的发展	xiao xue er tong xue xi dong ji de fa zhan	91
小学儿童学习迁移的特点	xiao xue er tong xue xi qian yi de te dian	103
小学儿童意志的发展	xiao xue er tong yi zhi de fa zhan	93
小学儿童知觉的发展	xiao xue er tong zhi jue de fa zhan	95
小学儿童注意的发展	xiao xue er tong zhu yi de fa zhan	87
心理发展中的遗传与环境因素	xin li fa zhan zhong de yi chuan yu huan jing yin su	36
性别图式理论	xing bie tu shi li lun	30
行为主义心理发展理论	xing wei zhu yi xin li fa zhan li lun	17
学龄前儿童的特征	xue ling qian er tong de te zheng	83
印刻	yin ke	35
婴儿的反射行为	ying er de fan she xing wei	32
婴儿期	ying er qi	4
婴幼儿发展量表	ying you er fa zhan liang biao	80
幼儿感觉的发展	you er gan jue de fa zhan	85
幼儿记忆的发展	you er ji yi de fa zhan	81
幼儿期	you er qi	3
幼儿情感的发展	you er qing gan de fa zhan	82
幼儿思维的发展	you er si wei de fa zhan	77
幼儿想象的发展	you er xiang xiang de fa zhan	78
幼儿意志的发展	you er yi zhi de fa zhan	79
幼儿注意的发展	you er zhu yi de fa zhan	86
幼儿自我意识的发展	you er zi wo yi shi de fa zhan	84
语言获得理论	yu yan huo de li lun	20
中学生记忆的发展	zhong xue sheng ji yi de fa zhan	107
中学生情感的发展	zhong xue sheng qing gan de fa zhan	110
中学生思维的发展	zhong xue sheng si wei de fa zhan	111
中学生想象的发展	zhong xue sheng xiang xiang de fa zhan	108
中学生意志的发展	zhong xue sheng yi zhi de fa zhan	109
中学生自我意识的发展	zhong xue sheng zi wo yi shi de fa zhan	106
自然结果与逻辑结果	zi ran jie guo yu luo ji jie guo	23
自我概念的发展	zi wo gai nian de fa zhan	75
自我评价的发展	zi wo ping jia de fa zhan	65
自我意识的发展	zi wo yi shi de fa zhan	74
自我中心言语	zi wo zhong xin yan yu	69
