# 文件名：继承法法律实务大全.scel
# 词库名：继承法法律实务大全
# 词库分类：法律
# 词库描述：
# 词条样例：死亡推定 继承权的取得 继承权的丧失 继承权放弃的效力 继承诉讼时效 不能作为遗产的权利义务
# 词条数量：99

必留份制度	bi liu fen zhi du	34
补充继承人受遗赠人	bu chong ji cheng ren shou yi zeng ren	35
不能作为遗产的权利义务	bu neng zuo wei yi chan de quan li yi wu	81
承包经营权的继受	cheng bao jing ying quan de ji shou	94
代书遗嘱	dai shu yi zhu	33
代位继承	dai wei ji cheng	59
代位继承人的范围	dai wei ji cheng ren de fan wei	63
代位继承人的应继份额	dai wei ji cheng ren de ying ji fen e	57
代位继承适用的条件	dai wei ji cheng shi yong de tiao jian	53
法定继承	fa ding ji cheng	71
法定继承的适用范围	fa ding ji cheng de shi yong fan wei	56
法定继承的特征	fa ding ji cheng de te zheng	54
法定继承人的范围	fa ding ji cheng ren de fan wei	60
法定继承人的继承顺序	fa ding ji cheng ren de ji cheng shun xu	64
法定继承人之父母	fa ding ji cheng ren zhi fu mu	67
法定继承人之继子女	fa ding ji cheng ren zhi ji zi nv	68
法定继承人之配偶	fa ding ji cheng ren zhi pei ou	66
法定继承人之亲生子女	fa ding ji cheng ren zhi qin sheng zi nv	70
法定继承人之丧偶儿媳女婿	fa ding ji cheng ren zhi sang ou er xi nv xu	51
法定继承人之兄弟姐妹	fa ding ji cheng ren zhi xiong di jie mei	65
法定继承人之养子女	fa ding ji cheng ren zhi yang zi nv	69
法定继承人之祖父母外祖父母	fa ding ji cheng ren zhi zu fu mu wai zu fu mu	55
放弃继承	fang qi ji cheng	24
非继承人对遗产的取得	fei ji cheng ren dui yi chan de qu de	62
夫妻遗产的确定	fu qi yi chan de que ding	7
附义务的遗嘱	fu yi wu de yi zhu	42
个人承包应得的个人收益的继承	ge ren cheng bao ying de de ge ren shou yi de ji cheng	73
公民的房屋	gong min de fang wu	96
公民的其他合法财产	gong min de qi ta he fa cai chan	95
公民的收入	gong min de shou ru	97
共同继承	gong tong ji cheng	21
公证遗嘱	gong zheng yi zhu	36
继承能力	ji cheng neng li	77
继承权	ji cheng quan	91
继承权的放弃	ji cheng quan de fang qi	79
继承权的绝对丧失	ji cheng quan de jue dui sang shi	76
继承权的取得	ji cheng quan de qu de	90
继承权的丧失	ji cheng quan de sang shi	88
继承权的相对丧失	ji cheng quan de xiang dui sang shi	87
继承权的行使	ji cheng quan de xing shi	89
继承权放弃的方式	ji cheng quan fang qi de fang shi	78
继承权放弃的效力	ji cheng quan fang qi de xiao li	84
继承权男女平等	ji cheng quan nan nv ping deng	72
继承权丧失的对人效力	ji cheng quan sang shi de dui ren xiao li	85
继承权丧失的确认	ji cheng quan sang shi de que ren	86
继承权丧失的时间效力	ji cheng quan sang shi de shi jian xiao li	75
继承人	ji cheng ren	93
继承诉讼时效	ji cheng su song shi xiao	83
继承通知	ji cheng tong zhi	25
继承行为能力	ji cheng xing wei neng li	92
家庭成员遗产的确定	jia ting cheng yuan yi chan de que ding	22
接受放弃受遗赠	jie shou fang qi shou yi zeng	23
接受继承	jie shou ji cheng	6
可取得遗产的人	ke qu de yi chan de ren	52
口头遗嘱	kou tou yi zhu	38
录音遗嘱	lu yin yi zhu	46
确定遗嘱能力的时间	que ding yi zhu neng li de shi jian	41
涉外继承	she wai ji cheng	1
涉外继承案件的专属管辖	she wai ji cheng an jian de zhuan shu guan xia	3
涉外继承的法律适用	she wai ji cheng de fa lv shi yong	2
死亡推定	si wang tui ding	98
胎儿有无继承能力	tai er you wu ji cheng neng li	80
无人继承遗产的处理	wu ren ji cheng yi chan de chu li	11
宣告死亡时间的确定	xuan gao si wang shi jian de que ding	99
遗产保管人	yi chan bao guan ren	20
遗产保管人的义务	yi chan bao guan ren de yi wu	19
遗产的处分	yi chan de chu fen	10
遗产的范围	yi chan de fan wei	82
遗产的分割	yi chan de fen ge	18
遗产分割的方法	yi chan fen ge de fang fa	9
遗产分割的时间	yi chan fen ge de shi jian	17
遗产分割的效力	yi chan fen ge de xiao li	16
遗产债务的范围	yi chan zhai wu de fan wei	14
遗产债务的清偿	yi chan zhai wu de qing chang	12
遗产债务的清偿顺序	yi chan zhai wu de qing chang shun xu	8
遗产债务的认定	yi chan zhai wu de ren ding	13
遗赠	yi zeng	31
遗赠的有效条件	yi zeng de you xiao tiao jian	37
遗赠的执行	yi zeng de zhi xing	39
遗赠扶养协议	yi zeng fu yang xie yi	15
遗赠扶养协议的法律效力	yi zeng fu yang xie yi de fa lv xiao li	5
遗赠扶养协议的解除	yi zeng fu yang xie yi de jie chu	4
遗嘱	yi zhu	48
遗嘱变更和撤销的方式	yi zhu bian geng he che xiao de fang shi	27
遗嘱的变更和撤销	yi zhu de bian geng he che xiao	44
遗嘱的不生效	yi zhu de bu sheng xiao	40
遗嘱的无效	yi zhu de wu xiao	28
遗嘱继承	yi zhu ji cheng	30
遗嘱继承的适用条件	yi zhu ji cheng de shi yong tiao jian	50
遗嘱继承人	yi zhu ji cheng ren	49
遗嘱见证人	yi zhu jian zheng ren	45
遗嘱能力	yi zhu neng li	47
遗嘱执行	yi zhu zhi xing	43
遗嘱执行人	yi zhu zhi xing ren	32
遗嘱执行人的权利义务	yi zhu zhi xing ren de quan li yi wu	26
转继承	zhuan ji cheng	58
转继承的条件和效力	zhuan ji cheng de tiao jian he xiao li	61
自然死亡时间的确定	zi ran si wang shi jian de que ding	74
自书遗嘱	zi shu yi zhu	29
