# 文件名：计生系统.scel
# 词库名：计生系统
# 词库分类：公共管理
# 词库描述：
# 词条样例：武义县妇幼保健院 柳城畲族镇 武义县中医院 桐琴镇 茭道镇
# 词条数量：26

白姆乡	bai mu xiang	10
白洋街道	bai yang jie dao	4
大田乡	da tian xiang	11
大溪口乡	da xi kou xiang	5
壶山街道	hu shan jie dao	3
茭道镇	jiao dao zhen	12
柳城畲族镇	liu cheng she zu zhen	19
履坦镇	lv tan zhen	18
泉溪镇	quan xi zhen	16
三港乡	san gang xiang	6
熟溪街道	shu xi jie dao	2
坦洪乡	tan hong xiang	8
桃溪镇	tao xi zhen	13
桐琴镇	tong qin zhen	17
王宅镇	wang zhai zhen	14
温泉度假区	wen quan du jia qu	1
武义人口计生局	wu yi ren kou ji sheng ju	25
武义县第二人民医院	wu yi xian di er ren min yi yuan	22
武义县第一人民医院	wu yi xian di yi ren min yi yuan	23
武义县妇幼保健院	wu yi xian fu you bao jian yuan	20
武义县计划生育协会	wu yi xian ji hua sheng yu xie hui	24
武义县人口和计划生育局	wu yi xian ren kou he ji hua sheng yu ju	26
武义县中医院	wu yi xian zhong yi yuan	21
西联乡	xi lian xiang	7
新宅镇	xin zhai zhen	15
俞源乡	yu yuan xiang	9
