# 文件名：金融保险行业词库.scel
# 词库名：金融保险行业词库
# 词库分类：金融保险
# 词库描述：
# 词条样例：美亚住院险 护身福保险 瑞鑫两全保险 家诺教育年金计划 养老医疗综合型
# 词条数量：107

安联安健一生	an lian an jian yi sheng	70
安联安康欣晴妨癌	an lian an kang xin qing fang ai	79
安联安顺齐天定期寿	an lian an shun qi tian ding qi shou	51
安联黄金计划	an lian huang jin ji hua	22
澳洲行	ao zhou xing	74
保运通货运险	bao yun tong huo yun xian	13
比赛保险	bi sai bao xian	82
比赛险	bi sai xian	36
出国人员意外险	chu guo ren yuan yi wai xian	23
大都会少儿天使	da du hui shao er tian shi	78
大众	da zhong	55
大众健康保险	da zhong jian kang bao xian	28
大众亚洲旅游保障	da zhong ya zhou lv you bao zhang	103
登山及户外运动	deng shan ji hu wai yun dong	68
东亚旅游保险	dong ya lv you bao xian	91
短期境外保险	duan qi jing wai bao xian	25
短线游天	duan xian you tian	6
儿童教育基金	er tong jiao yu ji jin	27
返还型重大疾病	fan huan xing zhong da ji bing	41
赴台游保险	fu tai you bao xian	16
赴台游保险产品	fu tai you bao xian chan pin	20
国寿康宁定期健康保障计划	guo shou kang ning ding qi jian kang bao zhang ji hua	67
国泰意外宝综合意外保障计划	guo tai yi wai bao zong he yi wai bao zhang ji hua	94
合众爱家寿险	he zhong ai jia shou xian	64
合众爱家无忧定期寿	he zhong ai jia wu you ding qi shou	50
护身福保险	hu shen fu bao xian	93
华泰旅行申根签证	hua tai lv xing shen gen qian zheng	63
滑翔伞的保险	hua xiang san de bao xian	71
滑翔翼的保险	hua xiang yi de bao xian	72
慧择白领健康保障	hui ze bai ling jian kang bao zhang	104
慧择保险网	hui ze bao xian wang	14
慧择大众健康保险	hui ze da zhong jian kang bao xian	37
慧择老年关爱	hui ze lao nian guan ai	54
慧择网	hui ze wang	1
婚嫁保险	hun jia bao xian	89
火车意外保险	huo che yi wai bao xian	61
疾病住院医疗	ji bing zhu yuan yi liao	48
家诺教育年金计划	jia nuo jiao yu nian jin ji hua	105
假日畅飞免费保险	jia ri chang fei mian fei bao xian	5
家庭综合意外险	jia ting zong he yi wai xian	95
建筑工人保险	jian zhu gong ren bao xian	32
建筑工人意外险	jian zhu gong ren yi wai xian	59
教育婚嫁	jiao yu hun jia	15
金领人生综合意外保险	jin ling ren sheng zong he yi wai bao xian	8
境外高风险	jing wai gao feng xian	96
境外公干意外险	jing wai gong gan yi wai xian	38
聚米保险	ju mi bao xian	12
聚米保险卡	ju mi bao xian ka	11
竣工保险	jun gong bao xian	2
康乐无忧	kang le wu you	10
老年关爱险	lao nian guan ai xian	47
旅行不便险	lv xing bu bian xian	44
旅游短线游	lv you duan xian you	99
美国自由行保险	mei guo zi you xing bao xian	86
美亚澳洲行	mei ya ao zhou xing	101
美亚宝岛游	mei ya bao dao you	45
美亚畅游天下	mei ya chang you tian xia	52
美亚健康险	mei ya jian kang xian	24
美亚万国游踪白银计划	mei ya wan guo you zong bai yin ji hua	43
美亚住院险	mei ya zhu yuan xian	100
女性重疾险	nv xing zhong ji xian	57
平安护身福健康保障计划	ping an hu shen fu jian kang bao zhang ji hua	29
平安险	ping an xian	19
平安智慧星教育金计划	ping an zhi hui xing jiao yu jin ji hua	76
平安住院团体医疗保险	ping an zhu yuan tuan ti yi liao bao xian	66
普通疾病住院保险	pu tong ji bing zhu yuan bao xian	17
亲子险	qin zi xian	35
全家人意外险	quan jia ren yi wai xian	46
人保旅行意外保险	ren bao lv xing yi wai bao xian	40
人身意外贷款保险	ren shen yi wai dai kuan bao xian	107
瑞鑫两全保险	rui xin liang quan bao xian	98
赛事安心险	sai shi an xin xian	97
赛事保险	sai shi bao xian	73
商业养老险	shang ye yang lao xian	81
生命大赢家年金保险万能型	sheng ming da ying jia nian jin bao xian wan neng xing	77
生命顺达境外紧急救援医疗	sheng ming shun da jing wai jin ji jiu yuan yi liao	102
生命一号理财	sheng ming yi hao li cai	75
生命一号年金保险	sheng ming yi hao nian jin bao xian	30
适合门窗安装工人的保险	shi he men chuang an zhuang gong ren de bao xian	60
岁以上老人保险	sui yi shang lao ren bao xian	7
岁以上重疾险	sui yi shang zhong ji xian	31
泰康两全保险	tai kang liang quan bao xian	87
泰康旅行意外保险	tai kang lv xing yi wai bao xian	39
泰康阳光旅程教育险	tai kang yang guang lv cheng jiao yu xian	88
太平洋产险	tai ping yang chan xian	65
太平洋吉利宝	tai ping yang ji li bao	80
务工保险	wu gong bao xian	85
西藏行保险	xi zang xing bao xian	62
消费型健康险	xiao fei xing jian kang xian	90
消費型重疾險	xiao fei xing zhong ji xian	84
学生出国留学保险	xue sheng chu guo liu xue bao xian	21
阳光儿童万能险	yang guang er tong wan neng xian	18
阳光人寿金泰福终身险	yang guang ren shou jin tai fu zhong shen xian	33
阳光人寿年年红两全保险	yang guang ren shou nian nian hong liang quan bao xian	3
养老医疗综合型	yang lao yi liao zong he xing	92
医疗事故赔偿	yi liao shi gu pei chang	56
一路平安网销版	yi lu ping an wang xiao ban	106
一日意外险	yi ri yi wai xian	26
一天保险	yi tian bao xian	49
意外保吉祥卡	yi wai bao ji xiang ka	42
意外保险哪个好	yi wai bao xian na ge hao	58
意外团体险	yi wai tuan ti xian	4
意外住院医疗	yi wai zhu yuan yi liao	53
运费险	yun fei xian	83
孕婴险	yun ying xian	34
中长期保险	zhong chang qi bao xian	9
中国人寿福禄鑫尊两全保险	zhong guo ren shou fu lu xin zun liang quan bao xian	69
