# 文件名：黄河.scel
# 词库名：黄河
# 词库分类：金融保险
# 词库描述：
# 词条样例：而把那个浑浊的那个 我就用矿泉水瓶 让我非常吃惊的发现 走的时候 四分之三已经变成了
# 词条数量：67

比喻我们痛苦的话	bi yu wo men tong ku de hua	49
不轻言放弃	bu qing yan fang qi	25
沉淀的泥沙	chen dian de ni sha	50
大概有一个小时左右	da gai you yi ge xiao shi zuo you	60
大化化验仪器批发站	da hua hua yan yi qi pi fa zhan	8
大家知道黄河水	da jia zhi dao huang he shui	63
但是	dan shi	19
德惠市	de hui shi	7
的篇目	de pian mu	32
懂得珍惜	dong de zhen xi	26
而把那个浑浊的那个	er ba na ge hun zhuo de na ge	51
而只有四分之一呢	er zhi you si fen zhi yi ne	56
非常清澈的一瓶水	fei chang qing che de yi ping shui	57
工商银行北京光机电	gong shang yin hang bei jing guang ji dian	39
公司大厦号楼层	gong si da sha hao lou ceng	44
灌了一瓶水	guan le yi ping shui	64
哈市阿城区	ha shi a cheng qu	9
海滨体育	hai bin ti yu	2
毫不犹豫地说	hao bu you yu de shuo	17
黑龙江亚华威	hei long jiang ya hua wei	43
宏亮天地广告有限公司	hong liang tian di guang gao you xian gong si	13
后来我就放在路边	hou lai wo jiu fang zai lu bian	61
湖南省五环路商贸	hu nan sheng wu huan lu shang mao	45
假如说我们把这瓶水	jia ru shuo wo men ba zhe ping shui	54
经贸有限公司	jing mao you xian gong si	42
流露着浓浓的诗情画意	liu lu zhe nong nong de shi qing hua yi	35
刘论昊	liu lun hao	4
每个人都经历过青春	mei ge ren dou jing li guo qing chun	22
那么一段美丽的回忆	na me yi duan mei li de hui yi	20
你就明白了	ni jiu ming bai le	48
你是否可以	ni shi fou ke yi	18
农村信用合作联社	nong cun xin yong he zuo lian she	6
浦发银行南湖支行	pu fa yin hang nan hu zhi hang	46
青春	qing chun	36
青春里拥有难以忘怀	qing chun li yong you nan yi wang huai	33
青春是生命之晨	qing chun shi sheng ming zhi chen	28
清水部分比喻	qing shui bu fen bi yu	53
让你的青春绽放出	rang ni de qing chun zhan fang chu	24
让我非常吃惊的发现	rang wo fei chang chi jing de fa xian	59
散发出淡淡的清香幽情	san fa chu dan dan de qing xiang you qing	34
上海市黄埔区山东中路	shang hai shi huang pu qu shan dong zhong lu	3
深圳深南中支行	shen zhen shen nan zhong zhi hang	10
是沉淀下的泥沙	shi chen dian xia de ni sha	55
是日之黎明	shi ri zhi li ming	27
四分之三已经变成了	si fen zhi san yi jing bian cheng le	58
特别的浑	te bie de hun	62
铁东支行	tie dong zhi hang	40
我就用矿泉水瓶	wo jiu yong kuang quan shui ping	65
我没有辜负青春	wo mei you gu fu qing chun	16
我们的幸福和快乐	wo men de xing fu he kuai le	52
我想那并不是	wo xiang na bing bu shi	15
我想送你一句话	wo xiang song ni yi ju hua	29
相信在你的青春中也有	xiang xin zai ni de qing chun zhong ye you	21
萧洪波	xiao hong bo	41
行北京灯市口支行	xing bei jing deng shi kou zhi hang	1
绚烂光彩	xuan lan guang cai	23
亚泰大街分社	ya tai da jie fen she	5
也有不堪回首的章节	ye you bu kan hui shou de zhang jie	31
一件简单的事	yi jian jian dan de shi	14
永定街爱国路	yong ding jie ai guo lu	37
拥有青春的朋友	yong you qing chun de peng you	30
有限责任公司	you xian ze ren gong si	11
有一次我在往黄河边上	you yi ci wo zai wang huang he bian shang	67
张宁宇	zhang ning yu	47
支行吴元辉	zhi hang wu yuan hui	38
中国邮政储蓄银行	zhong guo you zheng chu xu yin hang	12
走的时候	zou de shi hou	66
