# 文件名：卦石.scel
# 词库名：卦石
# 词库分类：办公文教
# 词库描述：
# 词条样例：比卦石 萃卦石 否卦石 随卦石 震卦石 小过卦石
# 词条数量：14

比卦石	bi gua shi	13
剥卦石	bo gua shi	14
萃卦石	cui gua shi	10
大过卦石	da guo gua shi	6
否卦石	fou gua shi	9
艮卦石	gen gua shi	8
观卦石	guan gua shi	12
恒卦石	heng gua shi	7
渐卦石	jian gua shi	1
随卦石	sui gua shi	5
小过卦石	xiao guo gua shi	2
益卦石	yi gua shi	4
豫卦石	yu gua shi	11
震卦石	zhen gua shi	3
