# 文件名：熙宁良品.scel
# 词库名：熙宁良品
# 词库分类：家居装饰
# 词库描述：
# 词条样例：天竺棉床笠 水洗棉床笠 天竺棉床单 水洗棉床单 羊毛床垫 熙宁良品
# 词条数量：19

单品	dan pin	13
聚氨酯记忆枕	ju an zhi ji yi zhen	7
水洗棉被套	shui xi mian bei tao	11
水洗棉床单	shui xi mian chuang dan	14
水洗棉床笠	shui xi mian chuang li	16
水洗棉四件套	shui xi mian si jian tao	19
水洗棉枕套	shui xi mian zhen tao	3
天竺棉被套	tian zhu mian bei tao	12
天竺棉床单	tian zhu mian chuang dan	15
天竺棉床笠	tian zhu mian chuang li	17
天竺棉四件套	tian zhu mian si jian tao	18
天竺棉枕套	tian zhu mian zhen tao	4
无印良品	wu yin liang pin	1
席梦思褥子	xi meng si ru zi	8
熙宁良品	xi ning liang pin	2
新款水洗棉	xin kuan shui xi mian	5
羊毛床垫	yang mao chuang dian	10
羊毛褥子	yang mao ru zi	9
羽毛枕	yu mao zhen	6
