# 文件名：玛格利塔.scel
# 词库名：玛格利塔
# 词库分类：饮食
# 词库描述：
# 词条样例：玛格利塔官网 玛格利塔加盟 玛格利塔加盟申请 玛格利塔合作 玛格利塔加盟电话 玛格利塔文化
# 词条数量：15

福州玛格利塔	fu zhou ma ge li ta	13
玛格利塔	ma ge li ta	15
玛格利塔餐饮	ma ge li ta can yin	6
玛格利塔餐饮公司	ma ge li ta can yin gong si	5
玛格利塔地址	ma ge li ta di zhi	7
玛格利塔电话	ma ge li ta dian hua	12
玛格利塔公司	ma ge li ta gong si	1
玛格利塔官网	ma ge li ta guan wang	14
玛格利塔合作	ma ge li ta he zuo	9
玛格利塔加盟	ma ge li ta jia meng	11
玛格利塔加盟电话	ma ge li ta jia meng dian hua	4
玛格利塔加盟方式	ma ge li ta jia meng fang shi	3
玛格利塔加盟申请	ma ge li ta jia meng shen qing	10
玛格利塔披萨	ma ge li ta pi sa	8
玛格利塔文化	ma ge li ta wen hua	2
