# 文件名：电商客服输入法.scel
# 词库名：电商客服输入法
# 词库分类：办公文教
# 词库描述：
# 词条样例：已退款 邮费 好的 能拍的都是有货的呢 真的不能再便宜了 一口价
# 词条数量：56

阿里巴巴	a li ba ba	19
抱歉不能指定快递	bao qian bu neng zhi ding kuai di	25
本店默认快递	ben dian mo ren kuai di	6
本店暂不支持指定快递	ben dian zan bu zhi chi zhi ding kuai di	7
不议价	bu yi jia	41
仓库已发出	cang ku yi fa chu	37
催促快递尽快派送	cui cu kuai di jin kuai pai song	1
当前合作的快递只有	dang qian he zuo de kuai di zhi you	24
地址没错吧	di zhi mei cuo ba	26
费用已经改好了	fei yong yi jing gai hao le	29
给个五星好评	gei ge wu xing hao ping	10
好的	hao de	47
慧聪网	hui cong wang	16
货送到哪里呢	huo song dao na li ne	22
尽快给你发出	jin kuai gei ni fa chu	44
京东	jing dong	13
快递爆仓	kuai di bao cang	4
麻烦您再看下核对下地址	ma fan nin zai kan xia he dui xia di zhi	27
麻烦评价下我的服务	ma fan ping jia xia wo de fu wu	9
麻烦亲发下照片	ma fan qin fa xia zhao pian	34
默认快递	mo ren kuai di	5
模式	mo shi	21
能拍的都是有货的呢	neng pai de dou shi you huo de ne	43
您好有什么可以帮你	nin hao you shen me ke yi bang ni	46
拍下今天就发货的呢	pai xia jin tian jiu fa huo de ne	54
企业对企业	qi ye dui qi ye	20
亲久等了	qin jiu deng le	36
亲是哪里的呢	qin shi na li de ne	23
亲下单吧	qin xia dan ba	28
请耐心等待一段时间	qing nai xin deng dai yi duan shi jian	3
如需指定快递请提前告知或备注	ru xu zhi ding kuai di qing ti qian gao zhi huo bei zhu	8
稍等	shao deng	39
生意宝	sheng yi bao	18
淘宝网	tao bao wang	15
提交一下呢	ti jiao yi xia ne	53
天猫	tian mao	14
网盛科技	wang sheng ke ji	17
我们发	wo men fa	45
我们这边审核	wo men zhe bian shen he	33
我们这就给你补	wo men zhe jiu gei ni bu	32
我们这就给你退	wo men zhe jiu gei ni tui	31
我去查一下	wo qu cha yi xia	38
我这就给你转	wo zhe jiu gei ni zhuan	35
物流堵住	wu liu du zhu	12
下雪封道送不出去	xia xue feng dao song bu chu qu	11
谢谢	xie xie	52
已返	yi fan	49
一口价	yi kou jia	40
已退款	yi tui kuan	50
邮费	you fei	48
邮费已改	you fei yi gai	30
有货的呢	you huo de ne	55
在的亲	zai de qin	56
真的不能再便宜了	zhen de bu neng zai pian yi le	42
正在联系快递	zheng zai lian xi kuai di	2
支付宝发下	zhi fu bao fa xia	51
