# 文件名：表格用词.scel
# 词库名：表格用词
# 词库分类：办公文教
# 词库描述：
# 词条样例：奔腾电饭锅 九阳电压力锅 韩派电暖锅 天际炖锅 美的微波炉 精品四件套
# 词条数量：18

爱仕达二件套	ai shi da er jian tao	4
奥克斯电饭锅	ao ke si dian fan guo	13
奥克斯电水壶	ao ke si dian shui hu	10
奔腾电饭锅	ben teng dian fan guo	18
瓷碗	ci wan	3
飞科挂烫机	fei ke gua tang ji	14
韩派电暖锅	han pai dian nuan guo	16
精品四件套	jing pin si jian tao	1
九阳电饭锅	jiu yang dian fan guo	9
九阳电压力锅	jiu yang dian ya li guo	17
九阳料理机	jiu yang liao li ji	6
六合蒸锅	lu he zheng guo	15
美的升电饭锅	mei di sheng dian fan guo	7
美的微波炉	mei di wei bo lu	8
四件套	si jian tao	5
苏记炒锅	su ji chao guo	11
天际炖锅	tian ji dun guo	12
养生壶	yang sheng hu	2
