# 文件名：雅丽洁化妆品.scel
# 词库名：雅丽洁化妆品
# 词库分类：美容护肤
# 词库描述：
# 词条样例：雅丽洁薰衣草水 雅丽洁护发弹力素 雅丽洁卷发弹力素 银杏丝质护发素 雅丽洁绿茶补水免洗面膜
# 词条数量：193

白菜净白睡眠面膜	bai cai jing bai shui mian mian mo	2
百合芍药面膜	bai he shao yao mian mo	14
白肌面贴	bai ji mian tie	107
倍蚕丝凝白面贴	bei can si ning bai mian tie	113
倍蚕丝凝水面贴	bei can si ning shui mian tie	115
倍蚕丝水	bei can si shui	103
倍蚕丝弹力美白面贴	bei can si tan li mei bai mian tie	114
杯水白肌精华液	bei shui bai ji jing hua ye	145
杯水白肌面奶	bei shui bai ji mian nai	148
杯水白肌乳	bei shui bai ji ru	146
杯水白肌水	bei shui bai ji shui	147
杯水白肌妆前乳	bei shui bai ji zhuang qian ru	140
杯水冰川面奶	bei shui bing chuan mian nai	149
杯水补水面奶	bei shui bu shui mian nai	79
杯水补水面贴	bei shui bu shui mian tie	7
杯水面膜	bei shui mian mo	109
杯水面贴	bei shui mian tie	69
杯水男士劲爽控油爽肤水	bei shui nan shi jin shuang kong you shuang fu shui	118
杯水润肌精华液	bei shui run ji jing hua ye	144
杯水润肌面奶	bei shui run ji mian nai	141
杯水润肌柔肤液	bei shui run ji rou fu ye	143
杯水润肌眼走珠	bei shui run ji yan zou zhu	142
冰川面贴	bing chuan mian tie	106
蚕丝红景天睡眠面膜	can si hong jing tian shui mian mian mo	5
蚕丝胶原蛋白睡眠面膜	can si jiao yuan dan bai shui mian mian mo	4
逗儿蚊不叮乳	dou er wen bu ding ru	173
逗儿蚊不叮水	dou er wen bu ding shui	174
海洋红景天睡眠面膜	hai yang hong jing tian shui mian mian mo	6
号去痘面奶	hao qu dou mian nai	31
荷花面膜	he hua mian mo	16
鸡蛋面膜	ji dan mian mo	10
极地冰川补水睡眠面膜	ji di bing chuan bu shui shui mian mian mo	3
绿茶补水睡眠面膜	lv cha bu shui shui mian mian mo	1
玫瑰水	mei gui shui	104
葡萄籽面膜	pu tao zi mian mo	13
润肌面贴	run ji mian tie	108
圣女果面膜	sheng nv guo mian mo	12
蜗牛面膜	wo niu mian mo	19
西印度面膜	xi yin du mian mo	11
西柚面膜	xi you mian mo	18
仙人掌面膜	xian ren zhang mian mo	15
小甘菊面膜	xiao gan ju mian mo	9
新乐新橄榄粉底液亮肤色	xin le xin gan lan fen di ye liang fu se	131
新乐新橄榄粉底液自然色	xin le xin gan lan fen di ye zi ran se	132
新乐新活泉露	xin le xin huo quan lu	155
新乐新活泉面奶	xin le xin huo quan mian nai	153
新乐新活泉霜	xin le xin huo quan shuang	154
新乐新活泉爽肤水	xin le xin huo quan shuang fu shui	156
新乐新美白化妆水	xin le xin mei bai hua zhuang shui	157
新乐新美白润肤霜	xin le xin mei bai run fu shuang	158
新乐新柔顺保湿啫喱膏	xin le xin rou shun bao shi ze li gao	136
新乐新水润深层霜	xin le xin shui run shen ceng shuang	159
新乐新皙白粉底瓷白色	xin le xin xi bai fen di ci bai se	130
新乐新皙白粉底象牙色	xin le xin xi bai fen di xiang ya se	129
新乐新皙白去角质	xin le xin xi bai qu jiao zhi	135
新乐新皙白乳液	xin le xin xi bai ru ye	133
新乐新皙白霜	xin le xin xi bai shuang	160
新乐新盈润亮丽啫喱膏	xin le xin ying run liang li ze li gao	134
薰衣草水	xun yi cao shui	102
雅丽洁白菜净白免洗面膜	ya li jie bai cai jing bai mian xi mian mo	186
雅丽洁白茶面膜免洗	ya li jie bai cha mian mo mian xi	112
雅丽洁白茶免洗面膜	ya li jie bai cha mian xi mian mo	29
雅丽洁保湿润养面贴	ya li jie bao shi run yang mian tie	96
雅丽洁倍蚕丝柔滑细白面膜	ya li jie bei can si rou hua xi bai mian mo	24
雅丽洁倍蚕丝水	ya li jie bei can si shui	77
雅丽洁冰川水	ya li jie bing chuan shui	183
雅丽洁蚕丝蛋白洁面膏	ya li jie can si dan bai jie mian gao	90
雅丽洁蚕丝红景天面膜	ya li jie can si hong jing tian mian mo	42
雅丽洁蚕丝红景天免洗面膜	ya li jie can si hong jing tian mian xi mian mo	188
雅丽洁蚕丝胶原蛋白免洗	ya li jie can si jiao yuan dan bai mian xi	39
雅丽洁草莓洗手液	ya li jie cao mei xi shou ye	83
雅丽洁茶树发水	ya li jie cha shu fa shui	26
雅丽洁多效修护乳液洗发露	ya li jie duo xiao xiu hu ru ye xi fa lu	22
雅丽洁蜂胶保湿面奶	ya li jie feng jiao bao shi mian nai	94
雅丽洁蜂胶沐浴露	ya li jie feng jiao mu yu lu	64
雅丽洁蜂蜜优格洁面膏	ya li jie feng mi you ge jie mian gao	93
雅丽洁丰盈造型弹力素	ya li jie feng ying zao xing tan li su	162
雅丽洁骨胶原润体乳	ya li jie gu jiao yuan run ti ru	73
雅丽洁海盐毛孔洁面膏	ya li jie hai yan mao kong jie mian gao	91
雅丽洁海洋动力免洗	ya li jie hai yang dong li mian xi	38
雅丽洁海洋水动力免洗面膜	ya li jie hai yang shui dong li mian xi mian mo	192
雅丽洁号去痘膏	ya li jie hao qu dou gao	37
雅丽洁恒透补水体乳	ya li jie heng tou bu shui ti ru	72
雅丽洁红酒面膜	ya li jie hong jiu mian mo	41
雅丽洁红洒多酚免洗面膜	ya li jie hong sa duo fen mian xi mian mo	191
雅丽洁护发弹力素	ya li jie hu fa tan li su	179
雅丽洁护发油	ya li jie hu fa you	51
雅丽洁护肤精纯油	ya li jie hu fu jing chun you	50
雅丽洁黄瓜水	ya li jie huang gua shui	185
雅丽洁活泉去屑洗发水	ya li jie huo quan qu xie xi fa shui	61
雅丽洁极地冰川面膜	ya li jie ji di bing chuan mian mo	43
雅丽洁极地冰川免洗面膜	ya li jie ji di bing chuan mian xi mian mo	189
雅丽洁激情香水沐浴露	ya li jie ji qing xiang shui mu yu lu	99
雅丽洁激情香水盐	ya li jie ji qing xiang shui yan	36
雅丽洁净白隔离霜	ya li jie jing bai ge li shuang	167
雅丽洁净白箐华霜	ya li jie jing bai jing hua shuang	168
雅丽洁净白乳	ya li jie jing bai ru	170
雅丽洁净白爽肤水	ya li jie jing bai shuang fu shui	171
雅丽洁卷发弹力素	ya li jie juan fa tan li su	178
雅丽洁辣椒去角质凝露	ya li jie la jiao qu jiao zhi ning lu	76
雅丽洁浪漫袋盐	ya li jie lang man dai yan	45
雅丽洁浪漫沐浴露	ya li jie lang man mu yu lu	53
雅丽洁浪漫香水沐浴露	ya li jie lang man xiang shui mu yu lu	98
雅丽洁浪漫香水盐	ya li jie lang man xiang shui yan	33
雅丽洁立体蓬卷啫喱膏	ya li jie li ti peng juan ze li gao	161
雅丽洁恋爱份子眼膜	ya li jie lian ai fen zi yan mo	88
雅丽洁芦荟多效洗发水	ya li jie lu hui duo xiao xi fa shui	60
雅丽洁芦荟胶	ya li jie lu hui jiao	110
雅丽洁芦荟水	ya li jie lu hui shui	184
雅丽洁绿茶补水免洗面膜	ya li jie lv cha bu shui mian xi mian mo	187
雅丽洁绿茶活力清爽洗发露	ya li jie lv cha huo li qing shuang xi fa lu	23
雅丽洁绿茶面膜免洗	ya li jie lv cha mian mo mian xi	111
雅丽洁绿茶免洗面膜	ya li jie lv cha mian xi mian mo	30
雅丽洁绿茶洗发水	ya li jie lv cha xi fa shui	63
雅丽洁美白紧致面贴	ya li jie mei bai jin zhi mian tie	68
雅丽洁美白柔滑面奶	ya li jie mei bai rou hua mian nai	78
雅丽洁玫瑰护肤油	ya li jie mei gui hu fu you	52
雅丽洁玫瑰沐浴	ya li jie mei gui mu yu	27
雅丽洁玫瑰沐浴露	ya li jie mei gui mu yu lu	59
雅丽洁玫瑰身体去角质	ya li jie mei gui shen ti qu jiao zhi	74
雅丽洁玫瑰水	ya li jie mei gui shui	182
雅丽洁密集补水面贴	ya li jie mi ji bu shui mian tie	95
雅丽洁蜜桃发水	ya li jie mi tao fa shui	28
雅丽洁明媚袋盐	ya li jie ming mei dai yan	48
雅丽洁明媚沐浴露	ya li jie ming mei mu yu lu	55
雅丽洁明媚香水沐浴露	ya li jie ming mei xiang shui mu yu lu	100
雅丽洁柠檬洗手液	ya li jie ning meng xi shou ye	86
雅丽洁凝水面奶	ya li jie ning shui mian nai	169
雅丽洁牛奶面膜	ya li jie niu nai mian mo	40
雅丽洁牛奶沐浴	ya li jie niu nai mu yu	25
雅丽洁牛奶沐浴露	ya li jie niu nai mu yu lu	57
雅丽洁牛奶嫩白免洗面膜	ya li jie niu nai nen bai mian xi mian mo	190
雅丽洁牛奶洗手液	ya li jie niu nai xi shou ye	84
雅丽洁苹果酸控油洁面膏	ya li jie ping guo suan kong you jie mian gao	92
雅丽洁青苹果洗手液	ya li jie qing ping guo xi shou ye	85
雅丽洁曲发弹力素	ya li jie qu fa tan li su	58
雅丽洁柔滑细白面贴	ya li jie rou hua xi bai mian tie	89
雅丽洁柔美袋盐	ya li jie rou mei dai yan	46
雅丽洁柔美香水沐浴露	ya li jie rou mei xiang shui mu yu lu	97
雅丽洁柔美香水盐	ya li jie rou mei xiang shui yan	34
雅丽洁柔敏面奶	ya li jie rou min mian nai	164
雅丽洁柔敏霜	ya li jie rou min shuang	166
雅丽洁柔敏水	ya li jie rou min shui	165
雅丽洁乳液修护洗发水	ya li jie ru ye xiu hu xi fa shui	62
雅丽洁润肌喷雾	ya li jie run ji pen wu	49
雅丽洁神秘香水沐浴露	ya li jie shen mi xiang shui mu yu lu	56
雅丽洁神秘香水盐	ya li jie shen mi xiang shui yan	35
雅丽洁时尚造型啫喱膏	ya li jie shi shang zao xing ze li gao	163
雅丽洁丝瓜霜	ya li jie si gua shuang	65
雅丽洁丝瓜水	ya li jie si gua shui	180
雅丽洁丝滑嫩白体乳	ya li jie si hua nen bai ti ru	71
雅丽洁私信杏仁面膜	ya li jie si xin xing ren mian mo	20
雅丽洁弹力滋润面贴	ya li jie tan li zi run mian tie	67
雅丽洁新乐新熏衣草补水乳液	ya li jie xin le xin xun yi cao bu shui ru ye	116
雅丽洁杏仁面膜	ya li jie xing ren mian mo	21
雅丽洁薰衣草去角质凝露	ya li jie xun yi cao qu jiao zhi ning lu	75
雅丽洁薰衣草水	ya li jie xun yi cao shui	181
雅丽洁薰衣草洗手液	ya li jie xun yi cao xi shou ye	82
雅丽洁压边化妆棉	ya li jie ya bian hua zhuang mian	81
雅丽洁压缩面膜	ya li jie ya suo mian mo	66
雅丽洁洋甘菊免洗面膜	ya li jie yang gan ju mian xi mian mo	44
雅丽洁洋甘菊免洗面奶	ya li jie yang gan ju mian xi mian nai	193
雅丽洁益肤粉刺面奶	ya li jie yi fu fen ci mian nai	152
雅丽洁益肤加强面奶	ya li jie yi fu jia qiang mian nai	151
雅丽洁益肤水	ya li jie yi fu shui	150
雅丽洁银杏防晒	ya li jie yin xing fang shai	117
雅丽洁银杏焗油头皮按摩膏	ya li jie yin xing ju you tou pi an mo gao	126
雅丽洁优雅袋盐	ya li jie you ya dai yan	47
雅丽洁优雅迷情体乳	ya li jie you ya mi qing ti ru	70
雅丽洁优雅沐浴露	ya li jie you ya mu yu lu	54
雅丽洁优雅香水沐浴露	ya li jie you ya xiang shui mu yu lu	101
雅丽洁优雅香水盐	ya li jie you ya xiang shui yan	32
雅丽洁纸纤维化妆棉	ya li jie zhi xian wei hua zhuang mian	80
雅丽洁竹炭控油去黑头套	ya li jie zhu tan kong you qu hei tou tao	87
银杏草本滋润去屑洗发露	yin xing cao ben zi run qu xie xi fa lu	119
银杏防晒	yin xing fang shai	125
银杏净白面奶	yin xing jing bai mian nai	172
银杏焗油发水	yin xing ju you fa shui	121
银杏焗油护发素	yin xing ju you hu fa su	175
银杏男士爽肤净化水	yin xing nan shi shuang fu jing hua shui	120
银杏凝水保湿霜	yin xing ning shui bao shi shuang	137
银杏凝水霜	yin xing ning shui shuang	139
银杏柔润凝水露	yin xing rou run ning shui lu	138
银杏水养发水	yin xing shui yang fa shui	123
银杏水养护发素	yin xing shui yang hu fa su	176
银杏丝质发水	yin xing si zhi fa shui	124
银杏丝质护发素	yin xing si zhi hu fa su	177
银杏头皮按摩膏去油	yin xing tou pi an mo gao qu you	128
银杏头皮水养按摩膏	yin xing tou pi shui yang an mo gao	127
银杏滋润去屑发水	yin xing zi run qu xie fa shui	122
萦肤特沐浴套	ying fu te mu yu tao	8
樱花面膜	ying hua mian mo	17
植物芦荟水	zhi wu lu hui shui	105
