# 文件名：宝马竞速赛.scel
# 词库名：宝马竞速赛
# 词库分类：角色扮演
# 词库描述：
# 词条样例：五年花下醉骑行 平明骑马入宫门 竹杖芒鞋轻胜马 此日六军同驻马 竹马踉跄冲淖去 猎马带禽归
# 词条数量：33

鞍前马后	an qian ma hou	7
不教胡马度阴山	bu jiao hu ma du yin shan	32
曾经伯乐识长鸣	ceng jing bo le shi chang ming	24
车如流水马如龙	che ru liu shui ma ru long	17
此日六军同驻马	ci ri liu jun tong zhu ma	26
高头大马	gao tou da ma	2
古道西风瘦马	gu dao xi feng shou ma	9
汗马功劳	han ma gong lao	3
何须马革裹尸还	he xu ma ge guo shi hai	15
胡马依北风	hu ma yi bei feng	13
挥鞭万里去	hui bian wan li qu	22
郎骑竹马来	lang qi zhu ma lai	20
猎马带禽归	lie ma dai qin gui	18
马齿徒增	ma chi tu zeng	4
马工枚速	ma gong mei su	1
马上相逢无纸笔	ma shang xiang feng wu zhi bi	27
马蹄催趁月明归	ma ti cui chen yue ming gui	14
马寅识路真疲路	ma yin shi lu zhen pi lu	10
马作的卢飞快	ma zuo di lu fei kuai	25
年年跃马长安市	nian nian yue ma chang an shi	12
平明骑马入宫门	ping ming qi ma ru gong men	30
乞儿马医	qi er ma yi	8
千里追风也不难	qian li zhui feng ye bu nan	19
射人先射马	she ren xian she ma	23
万马齐喑究可哀	wan ma qi yin jiu ke ai	11
五年花下醉骑行	wu nian hua xia zui qi xing	31
萧萧班马鸣	xiao xiao ban ma ming	29
雪拥蓝关马不前	xue yong lan guan ma bu qian	33
饮马渡秋水	yin ma du qiu shui	16
招兵买马	zhao bing mai ma	6
指鹿为马	zhi lu wei ma	5
竹马踉跄冲淖去	zhu ma liang qiang chong nao qu	21
竹杖芒鞋轻胜马	zhu zhang mang xie qing sheng ma	28
