# 文件名：翰墨之道嘎嘎.scel
# 词库名：翰墨之道嘎嘎
# 词库分类：梦幻西游
# 词库描述：
# 词条样例：动刀甚微謋然已解如土委地 有用者不可借不能用者求借 人生寄一世奄忽若飙尘 入鹿群之内取鹿乳以供亲 长风破浪会有时直挂云帆济沧海
# 词条数量：44

八悌八孝篇舜妹爱兄敬及皇英	ba ti ba xiao pian shun mei ai xiong jing ji huang ying	4
备周则意怠常见则不疑	bei zhou ze yi dai chang jian ze bu yi	8
不生不灭不垢不净不增不减	bu sheng bu mie bu gou bu jing bu zeng bu jian	21
采莲南塘秋莲花过人头	cai lian nan tang qiu lian hua guo ren tou	42
长风破浪会有时直挂云帆济沧海	chang feng po lang hui you shi zhi gua yun fan ji cang hai	41
动刀甚微謋然已解如土委地	dong dao shen wei huo ran yi jie ru tu wei di	29
废兴虽万变宪章亦已沦	fei xing sui wan bian xian zhang yi yi lun	38
感父救母千古令誉	gan fu jiu mu qian gu ling yu	3
孤灯不明思欲绝卷帷望月空长叹	gu deng bu ming si yu jue juan wei wang yue kong chang tan	12
混沌之时阴阳未判	hun dun zhi shi yin yang wei pan	36
借言以会意意尽无会处	jie yan yi hui yi yi jin wu hui chu	43
君子入则致孝于亲出则致节于国	jun zi ru ze zhi xiao yu qin chu ze zhi jie yu guo	14
诳也非诳也实其所诳也	kuang ye fei kuang ye shi qi suo kuang ye	6
困敌之势不以战损刚益柔	kun di zhi shi bu yi zhan sun gang yi rou	5
溟滓濛洪如鸡子玄黄之中生自然	ming zi meng hong ru ji zi xuan huang zhi zhong sheng zi ran	37
母来不得相见是以悲耳	mu lai bu de xiang jian shi yi bei er	16
翘迹企颍阳临河思洗耳	qiao ji qi ying yang lin he si xi er	34
巧笑倩兮美目盼兮	qiao xiao qian xi mei mu pan xi	35
鬈鬣蔽青天何由睹蓬莱	quan lie bi qing tian he you du peng lai	33
人生寄一世奄忽若飙尘	ren sheng ji yi shi yan hu ruo biao chen	44
入鹿群之内取鹿乳以供亲	ru lu qun zhi nei qu lu ru yi gong qin	40
三年技成而无所用其巧	san nian ji cheng er wu suo yong qi qiao	31
势必有损损阴以益阳	shi bi you sun sun yin yi yi yang	7
十方诸天尊其数如沙尘	shi fang zhu tian zun qi shu ru sha chen	27
是故兵胜于外义强于内	shi gu bing sheng yu wai yi qiang yu nei	18
蜀难之难难于上青天	shu nan zhi nan nan yu shang qing tian	17
硕鼠硕鼠无食我麦	shuo shu shuo shu wu shi wo mai	9
素枭二神灵驾护龙	su xiao er shen ling jia hu long	23
天地未形混沌未开万物未生	tian di wei xing hun dun wei kai wan wu wei sheng	26
天官赐福地官赫罪水官解厄	tian guan ci fu di guan he zui shui guan jie e	24
天生我材必有用千金散尽还复来	tian sheng wo cai bi you yong qian jin san jin huan fu lai	20
吞钩之鱼恨不忍饥	tun gou zhi yu hen bu ren ji	22
万物负阴而抱阳冲气以为和	wan wu fu yin er bao yang chong qi yi wei he	30
吾亦澹荡人拂衣可同调	wu yi dan dang ren fu yi ke tong diao	19
性聪惠然少贵骄颇不遵法度	xing cong hui ran shao gui jiao po bu zun fa du	11
璇玑悬斡晦魄环照	xuan ji xuan wo hui po huan zhao	25
谚云贵易交富易妻	yan yun gui yi jiao fu yi qi	39
疑之叩实察而后动复者阴之谋也	yi zhi kou shi cha er hou dong fu zhe yin zhi mou ye	15
阴阳翕辟万二千物具而有神焉	yin yang xi pi wan er qian wu ju er you shen yan	13
有用者不可借不能用者求借	you yong zhe bu ke jie bu neng yong zhe qiu jie	32
虞舜大孝竭力于田	yu shun da xiao jie li yu tian	1
远离颠倒梦想究竟涅盘	yuan li dian dao meng xiang jiu jing nie pan	28
则其所用者重而所要者轻也	ze qi suo yong zhe zhong er suo yao zhe qing ye	10
子路尽力负米奉亲	zi lu jin li fu mi feng qin	2
