# 文件名：龙族幻想.scel
# 词库名：龙族幻想
# 词库分类：角色扮演
# 词库描述：
# 词条样例：冬天到了春天还会远吗 极乐馆的老板娘是 蛇岐八家中负责风俗业的是 渗漏凝海上鸟道没云中赞美的是 阿尔卑斯山脉最高峰是
# 词条数量：157

阿尔卑斯山脉最高峰是勃朗峰	a er bei si shan mai zui gao feng shi bo lang feng	155
八卦社区	ba gua she qu	40
八卦之王	ba gua zhi wang	31
被称为菊月的月份是九月	bei cheng wei ju yue de yue fen shi jiu yue	154
北斗神话中英灵殿的名字是	bei dou shen hua zhong ying ling dian de ming zi shi	11
宠物可以区分为几种属性种类种	chong wu ke yi qu fen wei ji zhong shu xing zhong lei zhong	153
摧毁了中庭之蛇过山车的是夏妳	cui hui le zhong ting zhi she guo shan che de shi xia ni	152
答案昂热	da an ang re	104
答案邦达列夫	da an bang da lie fu	92
答案芬格尔	da an fen ge er	106
答案赫尔佐格	da an he er zuo ge	93
答案橘政宗	da an ju zheng zong	86
答案路明非	da an lu ming fei	95
答案路鸣泽	da an lu ming ze	101
答案曼施坦因教授	da an man shi tan yin jiao shou	87
答案诺诺	da an nuo nuo	102
答案犬山贺	da an quan shan he	90
答案上杉绘梨衣	da an shang shan hui li yi	103
答案是暴血	da an shi bao xue	9
答案是北欧	da an shi bei ou	12
答案是悲呛交响曲	da an shi bei qiang jiao xiang qu	18
答案是地动仪	da an shi di dong yi	5
答案是俄底修斯	da an shi e di xiu si	22
答案是吉他	da an shi ji ta	27
答案是鹿角	da an shi lu jiao	7
答案是马六甲海峡	da an shi ma liu jia hai xia	1
答案施耐德教授	da an shi nai de jiao shou	98
答案是青海湖	da an shi qing hai hu	14
答案是人参	da an shi ren shen	26
答案是瓦尔哈拉	da an shi wa er ha la	10
答案是王权	da an shi wang quan	16
答案是吸血镰	da an shi xi xue lian	21
答案是星座	da an shi xing zuo	19
答案是言灵	da an shi yan ling	24
答案是战斗中可以随时更换	da an shi zhan dou zhong ke yi sui shi geng huan	20
答案是只能在图书馆中阅读书籍	da an shi zhi neng zai tu shu guan zhong yue du shu ji	3
答案苏茜	da an su qian	96
答巴黎	da ba li	59
答白令海峡	da bai ling hai xia	79
答悲伧交响曲	da bei cang jiao xiang qu	50
答北欧	da bei ou	57
答勃朗峰	da bo lang feng	44
答臭氧	da chou yang	74
答楚子航	da chu zi hang	35
答第二大岛	da di er da dao	41
答地球仪	da di qiu yi	75
答俄低修斯	da e di xiu si	51
答法国	da fa guo	65
答风力	da feng li	61
答伏尔加河	da fu er jia he	63
答个	da ge	81
答哥本哈根	da ge ben ha gen	43
答交通工具	da jiao tong gong ju	77
答马六甲海峡	da ma liu jia hai xia	82
答曼施坦因教授	da man shi tan yin jiao shou	34
答墨西哥	da mo xi ge	53
答南极洲	da nan ji zhou	46
答诺诺	da nuo nuo	38
答其他答案提到的均需要	da qi ta da an ti dao de jun xu yao	84
答其他鸟的鸟巢里	da qi ta niao de niao chao li	72
答上杉绘梨衣	da shang shan hui li yi	32
答苏恩熙	da su en xi	37
答题	da ti	29
答夏妳	da xia ni	33
答悬空寺	da xuan kong si	69
答印度	da yin du	48
答银杉	da yin shan	55
答英国	da ying guo	67
答樱井明	da ying jing ming	36
答月亮引力	da yue liang yin li	70
冬天到了春天还会远吗语出雪莱	dong tian dao le chun tian hai hui yuan ma yu chu xue lai	157
高天原酒吧的店长是座头鲸	gao tian yuan jiu ba de dian zhang shi zuo tou jing	151
沟通太平洋和印度洋的水道是	gou tong tai ping yang he yin du yang de shui dao shi	2
关于阅读书籍以下说法错误的是	guan yu yue du shu ji yi xia shuo fa cuo wu de shi	4
海南岛是我国第几大岛第二大岛	hai nan dao shi wo guo di ji da dao di er da dao	150
海洋中最多的生物是浮游生物	hai yang zhong zui duo de sheng wu shi fu you sheng wu	149
荷马史诗奥德赛的主人公是	he ma shi shi ao de sai de zhu ren gong shi	23
黑天鹅港孤儿院的负责人是	hei tian e gang gu er yuan de fu ze ren shi	94
黑天鹅港位于西伯利亚	hei tian e gang wei yu xi bo li ya	148
伙伴能将多少属性转换给玩家	huo ban neng jiang duo shao shu xing zhuan huan gei wan jia	147
极乐馆的老板娘是樱井小慕	ji le guan de lao ban niang shi ying jing xiao mu	156
将狮心会爆血资料交给凯撒的是	jiang shi xin hui bao xue zi liao jiao gei kai sa de shi	97
将小黄鸭送给路明非的是	jiang xiao huang ya song gei lu ming fei de shi	89
举世闻名的泰姬陵在印度	ju shi wen ming de tai ji ling zai yin du	146
卡塞尔校园新闻频道的主编是	ka sai er xiao yuan xin wen pin dao de zhu bian shi	107
卡塞尔学院创始人是昂热	ka sai er xue yuan chuang shi ren shi ang re	145
卡塞尔学院的校长是	ka sai er xue yuan de xiao zhang shi	105
卡塞尔学院的校长是昂热	ka sai er xue yuan de xiao zhang shi ang re	144
卡塞尔学院风纪委员会主席是	ka sai er xue yuan feng ji wei yuan hui zhu xi shi	88
卡塞尔学院新闻主编是苏格尔	ka sai er xue yuan xin wen zhu bian shi su ge er	143
卡塞尔学院学生会的会长是凯撒	ka sai er xue yuan xue sheng hui de hui zhang shi kai sa	142
卡塞尔学院执行部负责人是	ka sai er xue yuan zhi xing bu fu ze ren shi	99
看见有人使用外挂怎么办举报	kan jian you ren shi yong wai gua zen me ban ju bao	141
恐龙属于爬行动物	kong long shu yu pa xing dong wu	140
六弦琴是什么乐器的别称	liu xian qin shi shen me yue qi de bie cheng	28
六弦琴是什么乐器的别称吉他	liu xian qin shi shen me yue qi de bie cheng ji ta	139
路明非的言灵是什么	lu ming fei de yan ling shi shen me	25
鹿茸是新生的	lu rong shi xin sheng de	8
每天最多可以获得多少助力值	mei tian zui duo ke yi huo de duo shao zhu li zhi	138
哪一类茶属于发酵茶红茶	na yi lei cha shu yu fa jiao cha hong cha	137
哪一类属于发酵茶红茶	na yi lei shu yu fa jiao cha hong cha	136
诺诺的未婚夫是凯撒	nuo nuo de wei hun fu shi kai sa	135
欧洲最长的河流是伏尔加河	ou zhou zui chang de he liu shi fu er jia he	131
欧洲最大半岛在北欧	ou zhou zui da ban dao zai bei ou	134
欧洲最大的半岛在	ou zhou zui da de ban dao zai	13
欧洲最大的半岛在北欧	ou zhou zui da de ban dao zai bei ou	133
欧洲最大的岛屿是大不列颠岛	ou zhou zui da de dao yu shi da bu lie dian dao	132
蒲公英靠什么传播种子风力	pu gong ying kao shen me chuan bo zhong zi feng li	130
七大洲中人口最少的是南极洲	qi da zhou zhong ren kou zui shao de shi nan ji zhou	129
七大洲中人口最少的州是南极洲	qi da zhou zhong ren kou zui shao de zhou shi nan ji zhou	128
人体消化道中最长的器官是小肠	ren ti xiao hua dao zhong zui chang de qi guan shi xiao chang	127
沙龙源于哪国语言法国	sha long yuan yu na guo yu yan fa guo	126
蛇岐八家的龙族血脉传承自白王	she qi ba jia de long zu xue mai chuan cheng zi bai wang	125
蛇岐八家中负责风俗业的家主是	she qi ba jia zhong fu ze feng su ye de jia zhu shi	91
世界第一枚邮票出现在英国	shi jie di yi mei you piao chu xian zai ying guo	124
问阿尔卑斯山脉最高峰是	wen a er bei si shan mai zui gao feng shi	45
问产生海水潮汐的主要原因是	wen chan sheng hai shui chao xi de zhu yao yuan yin shi	71
问杜鹃鸟不做窝她把蛋下到	wen du juan niao bu zuo wo ta ba dan xia dao	73
问改装座驾需要什么	wen gai zhuang zuo jia xu yao shen me	85
问沟通美洲与亚洲的水道是	wen gou tong mei zhou yu ya zhou de shui dao shi	80
问沟通太平洋和印度洋的水道是	wen gou tong tai ping yang he yin du yang de shui dao shi	83
问海南岛是我国第几大岛	wen hai nan dao shi wo guo di ji da dao	42
问荷马史诗奥德赛的主人公是	wen he ma shi shi ao de sai de zhu ren gong shi	52
问举世闻名的泰姬陵在	wen ju shi wen ming de tai ji ling zai	49
问欧洲最长的河流是	wen ou zhou zui chang de he liu shi	64
问欧洲最大半岛在	wen ou zhou zui da ban dao zai	58
问蒲公英靠什么传播种子	wen pu gong ying kao shen me chuan bo zhong zi	62
问七大洲中人口最少的州是	wen qi da zhou zhong ren kou zui shao de zhou shi	47
问人们最初发明滑冰是把它作为	wen ren men zui chu fa ming hua bing shi ba ta zuo wei	78
问沙龙源于哪国语言	wen sha long yuan yu na guo yu yan	66
问世界第一枚邮票出现在	wen shi jie di yi mei you piao chu xian zai	68
问有植物熊猫之称的是	wen you zhi wu xiong mao zhi cheng de shi	56
问月亮金字塔坐落在哪里	wen yue liang jin zi ta zuo luo zai na li	54
问中国四大发明不包括	wen zhong guo si da fa ming bu bao kuo	76
问著名的卢浮宫在	wen zhu ming de lu fu gong zai	60
问最擅长使用能力侧写的是	wen zui shan chang shi yong neng li ce xie de shi	39
我国面积最大的湖泊是	wo guo mian ji zui da de hu po shi	15
言灵刹那的拥有者是零	yan ling cha na de yong you zhe shi ling	123
言灵刹那的拥有者是犬山贺	yan ling cha na de yong you zhe shi quan shan he	121
言灵时间零的拥有者是	yan ling shi jian ling de yong you zhe shi	100
言灵时间零的拥有者是昂热	yan ling shi jian ling de yong you zhe shi ang re	122
艺名为右京橘的男演员是楚子昂	yi ming wei you jing ju de nan yan yuan shi chu zi ang	119
以下关于亲友宝箱描述正确地是	yi xia guan yu qin you bao xiang miao shu zheng que di shi	17
以下哪位是源稚生的助手矢吹樱	yi xia na wei shi yuan zhi sheng de zhu shou shi chui ying	120
有多少种铭文可供玩家进修种	you duo shao zhong ming wen ke gong wan jia jin xiu zhong	118
有植物熊猫之称的是银杉	you zhi wu xiong mao zhi cheng de shi yin shan	117
月亮金字塔坐落在哪里墨西哥	yue liang jin zi ta zuo luo zai na li mo xi ge	116
怎么增加羁绊值组队战斗	zen me zeng jia ji ban zhi zu dui zhan dou	115
智慧沙龙	zhi hui sha long	30
中国的四大发明不包括	zhong guo de si da fa ming bu bao kuo	6
中国四大发明不包括地球仪	zhong guo si da fa ming bu bao kuo di qiu yi	114
助力积分每日获取上限为	zhu li ji fen mei ri huo qu shang xian wei	113
著名的卢浮宫在巴黎	zhu ming de lu fu gong zai ba li	112
自由女神像位于纽约的港口	zi you nv shen xiang wei yu niu yue de gang kou	111
自有女神像位于纽约港口	zi you nv shen xiang wei yu niu yue gang kou	110
组织猛鬼众的领袖是王将	zu zhi meng gui zhong de ling xiu shi wang jiang	109
最擅长使用能力侧写的是诺诺	zui shan chang shi yong neng li ce xie de shi nuo nuo	108
