# 文件名：IT企业.scel
# 词库名：IT企业
# 词库分类：单位机构名
# 词库描述：
# 词条样例：昆明骏成 云南蓝泰 昆明锐博 云南特灵达新时 云南铺路爪 昆明通智达
# 词条数量：23

昆明爱迪	kun ming ai di	4
昆明邦正	kun ming bang zheng	8
昆明东润	kun ming dong run	20
昆明东星	kun ming dong xing	23
昆明瀚涛	kun ming han tao	16
昆明华创	kun ming hua chuang	11
昆明会达	kun ming hui da	6
昆明金利	kun ming jin li	3
昆明骏成	kun ming jun cheng	22
昆明满意	kun ming man yi	1
昆明锐博	kun ming rui bo	18
昆明泰克计	kun ming tai ke ji	9
昆明同想	kun ming tong xiang	19
昆明通智达	kun ming tong zhi da	7
昆明网博	kun ming wang bo	17
昆明新中通	kun ming xin zhong tong	10
昆明新洲源	kun ming xin zhou yuan	12
昆明扬洋	kun ming yang yang	5
云南巨佳	yun nan ju jia	2
云南蓝泰	yun nan lan tai	21
云南铺路爪	yun nan pu lu zhao	14
云南特灵达新时	yun nan te ling da xin shi	15
云南展浩特	yun nan zhan hao te	13
