# 文件名：宁德企业名单.scel
# 词库名：宁德企业名单
# 词库分类：单位机构名
# 词库描述：
# 词条样例：上海新艺佳物业有限公司 宁德时代投资有限公司 宁德市葆谊金属制品有限公司 福建联华植绒有限公司 屏南县永锋混凝土搅拌有限公司 周宁县顺通工贸有限公司
# 词条数量：344

安诺纸业福建有限公司	an nuo zhi ye fu jian you xian gong si	238
德泰钢业阀门有限公司	de tai gang ye fa men you xian gong si	323
福安市标迪机电有限公司	fu an shi biao di ji dian you xian gong si	40
福安市灿丰电子有限公司	fu an shi can feng dian zi you xian gong si	73
福安市昌隆电机有限公司	fu an shi chang long dian ji you xian gong si	9
福安市昌荣金属制品有限公司	fu an shi chang rong jin shu zhi pin you xian gong si	68
福安市陈孟清竹制品厂	fu an shi chen meng qing zhu zhi pin chang	79
福安市诚信燃料有限公司	fu an shi cheng xin ran liao you xian gong si	333
福安市城阳秦溪小学旁郑品生	fu an shi cheng yang qin xi xiao xue pang zheng pin sheng	53
福安市大成电机有限公司	fu an shi da cheng dian ji you xian gong si	54
福安市达丰电气有限公司	fu an shi da feng dian qi you xian gong si	8
福安市登鑫电机有限公司	fu an shi deng xin dian ji you xian gong si	10
福安市鼎力机械有限公司	fu an shi ding li ji xie you xian gong si	169
福安市东方红电机有限公司	fu an shi dong fang hong dian ji you xian gong si	32
福安市东福金属制品厂	fu an shi dong fu jin shu zhi pin chang	210
福安市东升电机有限公司	fu an shi dong sheng dian ji you xian gong si	286
福安市东升金属材料有限公司	fu an shi dong sheng jin shu cai liao you xian gong si	227
福安市方舟贸易有限公司	fu an shi fang zhou mao yi you xian gong si	65
福安市丰茂电机配件有限公司	fu an shi feng mao dian ji pei jian you xian gong si	196
福安市丰逾电机有限公司	fu an shi feng yu dian ji you xian gong si	26
福安市福雷思特电机有限公司	fu an shi fu lei si te dian ji you xian gong si	25
福安市富鸣冲压厂	fu an shi fu ming chong ya chang	50
福安市甘棠镇港坡村罗惠荣	fu an shi gan tang zhen gang po cun luo hui rong	52
福安市甘棠镇英岐村郑品霖	fu an shi gan tang zhen ying qi cun zheng pin lin	176
福安市冠容益利贸易有限公司	fu an shi guan rong yi li mao yi you xian gong si	57
福安市广发亚达电机有限公司	fu an shi guang fa ya da dian ji you xian gong si	11
福安市海发电机有限公司	fu an shi hai fa dian ji you xian gong si	30
福安市恒发电机有限公司	fu an shi heng fa dian ji you xian gong si	28
福安市恒辉金属制品有限公司	fu an shi heng hui jin shu zhi pin you xian gong si	187
福安市恒生船业有限公司	fu an shi heng sheng chuan ye you xian gong si	67
福安市鸿贸金属制品加工厂	fu an shi hong mao jin shu zhi pin jia gong chang	3
福安市宏腾公司天马山过磅点	fu an shi hong teng gong si tian ma shan guo bang dian	231
福安市宏鑫汽车修理厂	fu an shi hong xin qi che xiu li chang	104
福安市宏星电机有限公司	fu an shi hong xing dian ji you xian gong si	72
福安市华港电机配件有限公司	fu an shi hua gang dian ji pei jian you xian gong si	2
福安市华冠电机有限公司	fu an shi hua guan dian ji you xian gong si	19
福安市华航电机配件厂	fu an shi hua hang dian ji pei jian chang	327
福安市辉荣电机厂	fu an shi hui rong dian ji chang	31
福安市建顺金属制品有限公司	fu an shi jian shun jin shu zhi pin you xian gong si	205
福安市锦程金属制品有限公司	fu an shi jin cheng jin shu zhi pin you xian gong si	66
福安市金伦金属材料有限公司	fu an shi jin lun jin shu cai liao you xian gong si	76
福安市精艺电机有限公司	fu an shi jing yi dian ji you xian gong si	71
福安市立大机电制造厂	fu an shi li da ji dian zhi zao chang	41
福安市连升商贸有限公司	fu an shi lian sheng shang mao you xian gong si	232
福安市粮食购销有限责任公司	fu an shi liang shi gou xiao you xian ze ren gong si	246
福安市垅海电机有限公司	fu an shi long hai dian ji you xian gong si	16
福安市隆顺电机厂	fu an shi long shun dian ji chang	74
福安市马头造船有限责任公司	fu an shi ma tou zao chuan you xian ze ren gong si	64
福安市闽达经贸有限公司	fu an shi min da jing mao you xian gong si	281
福安市鹏捷电机制造有限公司	fu an shi peng jie dian ji zhi zao you xian gong si	29
福安市前进电机配件厂	fu an shi qian jin dian ji pei jian chang	77
福安市秦溪洋工业区上村桥头	fu an shi qin xi yang gong ye qu shang cun qiao tou	51
福安市日出金属材料有限公司	fu an shi ri chu jin shu cai liao you xian gong si	138
福安市荣椿电机厂	fu an shi rong chun dian ji chang	15
福安市森威机电有限公司	fu an shi sen wei ji dian you xian gong si	33
福安市上乐拢部队靶场	fu an shi shang le long bu dui ba chang	69
福安市晟安金属材料有限公司	fu an shi sheng an jin shu cai liao you xian gong si	136
福安市盛华光发电设备厂	fu an shi sheng hua guang fa dian she bei chang	6
福安市盛永丰金属材料有限公司	fu an shi sheng yong feng jin shu cai liao you xian gong si	197
福安市双煌电机有限公司	fu an shi shuang huang dian ji you xian gong si	36
福安市双菱电机有限公司	fu an shi shuang ling dian ji you xian gong si	21
福安市双源电机有限公司	fu an shi shuang yuan dian ji you xian gong si	13
福安市淞兴金属制品有限公司	fu an shi song xing jin shu zhi pin you xian gong si	305
福安市太平洋电机厂	fu an shi tai ping yang dian ji chang	56
福安市同济船业有限公司	fu an shi tong ji chuan ye you xian gong si	343
福安市通力电机有限公司	fu an shi tong li dian ji you xian gong si	63
福安市通盛合金制品有限公司	fu an shi tong sheng he jin zhi pin you xian gong si	230
福安市旺隆再生资源有限公司	fu an shi wang long zai sheng zi yuan you xian gong si	78
福安市先锋电机厂	fu an shi xian feng dian ji chang	24
福安市翔大电机有限公司	fu an shi xiang da dian ji you xian gong si	7
福安市祥锐电机有限公司	fu an shi xiang rui dian ji you xian gong si	43
福安市新安金属制品有限公司	fu an shi xin an jin shu zhi pin you xian gong si	137
福安市鑫久铝合金压铸有限公司	fu an shi xin jiu lv he jin ya zhu you xian gong si	80
福安市鑫茂冷轧硅钢有限公司	fu an shi xin mao leng zha gui gang you xian gong si	297
福安市鑫美印刷有限公司	fu an shi xin mei yin shua you xian gong si	1
福安市新宇通电机有限公司	fu an shi xin yu tong dian ji you xian gong si	23
福安市新源竹木业有限公司	fu an shi xin yuan zhu mu ye you xian gong si	58
福安市兴达电机有限公司	fu an shi xing da dian ji you xian gong si	20
福安市亚威电机有限责任公司	fu an shi ya wei dian ji you xian ze ren gong si	37
福安市亿电电机有限公司	fu an shi yi dian dian ji you xian gong si	22
福安市永特电机有限公司	fu an shi yong te dian ji you xian gong si	38
福安市宇辉农业有限公司	fu an shi yu hui nong ye you xian gong si	75
福安市宇信贸易有限公司	fu an shi yu xin mao yi you xian gong si	60
福安市远东华美电机有限公司	fu an shi yuan dong hua mei dian ji you xian gong si	62
福安市中南电机电器有限公司	fu an shi zhong nan dian ji dian qi you xian gong si	334
福鼎建大吉刀剪五金有限公司	fu ding jian da ji dao jian wu jin you xian gong si	91
福鼎利都超纤皮革有限公司	fu ding li dou chao xian pi ge you xian gong si	318
福鼎利泰超纤皮革有限公司	fu ding li tai chao xian pi ge you xian gong si	201
福鼎联华植绒皮饰有限公司	fu ding lian hua zhi rong pi shi you xian gong si	199
福鼎燃料有限公司	fu ding ran liao you xian gong si	105
福鼎盛隆包装有限公司	fu ding sheng long bao zhuang you xian gong si	122
福鼎市安然燃气有限公司	fu ding shi an ran ran qi you xian gong si	247
福鼎市白琳冯亦松废品收购站	fu ding shi bai lin feng yi song fei pin shou gou zhan	123
福鼎市白琳镇玉琳停车场	fu ding shi bai lin zhen yu lin ting che chang	96
福鼎市百胜新区石子场	fu ding shi bai sheng xin qu shi zi chang	120
福鼎市储备粮管理有限公司	fu ding shi chu bei liang guan li you xian gong si	214
福鼎市点头镇高志雄	fu ding shi dian tou zhen gao zhi xiong	95
福鼎市鼎翔建设工程有限公司	fu ding shi ding xiang jian she gong cheng you xian gong si	154
福鼎市贯岭扁铁加工场	fu ding shi guan ling bian tie jia gong chang	46
福鼎市贯岭国道检测站	fu ding shi guan ling guo dao jian ce zhan	175
福鼎市华成不锈钢管有限公司	fu ding shi hua cheng bu xiu gang guan you xian gong si	94
福鼎市华晟新材料有限公司	fu ding shi hua sheng xin cai liao you xian gong si	130
福鼎市京广建材实业有限公司	fu ding shi jing guang jian cai shi ye you xian gong si	295
福鼎市粮食储备有限公司	fu ding shi liang shi chu bei you xian gong si	146
福鼎市潘溪绿靑竹片制品厂	fu ding shi pan xi lv qing zhu pian zhi pin chang	81
福鼎市厦联电器有限公司	fu ding shi sha lian dian qi you xian gong si	92
福鼎市石林水泥制品有限公司	fu ding shi shi lin shui ni zhi pin you xian gong si	266
福鼎市桐山兴业扁铁加工场	fu ding shi tong shan xing ye bian tie jia gong chang	47
福鼎市万泰纸业有限公司	fu ding shi wan tai zhi ye you xian gong si	121
福鼎市翔安竹叶有限公司	fu ding shi xiang an zhu ye you xian gong si	82
福鼎市中洲建材有限公司	fu ding shi zhong zhou jian cai you xian gong si	124
福鼎永大合成革有限公司	fu ding yong da he cheng ge you xian gong si	215
福鼎永强合成革有限公司	fu ding yong qiang he cheng ge you xian gong si	112
福建爱邦电器有限公司	fu jian ai bang dian qi you xian gong si	145
福建埃美柯电机有限公司	fu jian ai mei ke dian ji you xian gong si	14
福建艾诺贸易有限公司	fu jian ai nuo mao yi you xian gong si	282
福建安居轩门业有限公司	fu jian an ju xuan men ye you xian gong si	4
福建邦德合成革集团有限公司	fu jian bang de he cheng ge ji tuan you xian gong si	224
福建博瑞特电机有限公司	fu jian bo rui te dian ji you xian gong si	55
福建伯特利技术开发有限公司	fu jian bo te li ji shu kai fa you xian gong si	298
福建博艺材料科技有限公司	fu jian bo yi cai liao ke ji you xian gong si	234
福建超大畜牧业有限公司	fu jian chao da xu mu ye you xian gong si	165
福建德孚燃油发展有限公司	fu jian de fu ran you fa zhan you xian gong si	244
福建鼎峰合成革有限公司	fu jian ding feng he cheng ge you xian gong si	106
福建鼎信实业有限公司	fu jian ding xin shi ye you xian gong si	300
福建东联机车部件有限公司	fu jian dong lian ji che bu jian you xian gong si	93
福建东胜合成革有限公司	fu jian dong sheng he cheng ge you xian gong si	160
福建东元精工有限公司	fu jian dong yuan jing gong you xian gong si	303
福建福安闽东亚南电机有限公司	fu jian fu an min dong ya nan dian ji you xian gong si	12
福建福丰实业有限公司	fu jian fu feng shi ye you xian gong si	285
福建福华皮革有限公司	fu jian fu hua pi ge you xian gong si	110
福建贵宁煤炭有限公司	fu jian gui ning mei tan you xian gong si	219
福建海和实业有限公司	fu jian hai he shi ye you xian gong si	152
福建汉邦建材有限公司	fu jian han bang jian cai you xian gong si	331
福建合盛革业有限公司	fu jian he sheng ge ye you xian gong si	116
福建恒华船务有限公司	fu jian heng hua chuan wu you xian gong si	48
福建恒力混凝土搅拌有限公司	fu jian heng li hun ning tu jiao ban you xian gong si	268
福建宏大特钢有限公司	fu jian hong da te gang you xian gong si	126
福建宏福皮革有限公司	fu jian hong fu pi ge you xian gong si	128
福建华隆金属制品有限公司	fu jian hua long jin shu zhi pin you xian gong si	156
福建华日汽车配件有限公司	fu jian hua ri qi che pei jian you xian gong si	186
福建华泰皮革有限公司	fu jian hua tai pi ge you xian gong si	129
福建华夏合成革有限公司	fu jian hua xia he cheng ge you xian gong si	115
福建嘉华布业有限公司	fu jian jia hua bu ye you xian gong si	321
福建建德燃料贸易有限公司	fu jian jian de ran liao mao yi you xian gong si	293
福建江南非织造布有限公司	fu jian jiang nan fei zhi zao bu you xian gong si	131
福建金诚合成革有限公司	fu jian jin cheng he cheng ge you xian gong si	125
福建金汇实业有限公司	fu jian jin hui shi ye you xian gong si	195
福建璟榕工程建设发展有限公司	fu jian jing rong gong cheng jian she fa zhan you xian gong si	311
福建君德实业开发有限公司	fu jian jun de shi ye kai fa you xian gong si	239
福建乐发铜业有限公司	fu jian le fa tong ye you xian gong si	149
福建联德企业有限公司	fu jian lian de qi ye you xian gong si	338
福建联华植绒有限公司	fu jian lian hua zhi rong you xian gong si	337
福建联盛合成革有限公司	fu jian lian sheng he cheng ge you xian gong si	117
福建隆祥皮革有限公司	fu jian long xiang pi ge you xian gong si	109
福建闽东电机有限公司	fu jian min dong dian ji you xian gong si	35
福建闽东捷成金属制品有限公司	fu jian min dong jie cheng jin shu zhi pin you xian gong si	294
福建闽孚化工有限公司	fu jian min fu hua gong you xian gong si	240
福建宁德国家粮食储备库	fu jian ning de guo jia liang shi chu bei ku	260
福建诺卡本冷轧电工钢有限公司	fu jian nuo ka ben leng zha dian gong gang you xian gong si	181
福建欧荣布业有限公司	fu jian ou rong bu ye you xian gong si	242
福建强盛植绒有限公司	fu jian qiang sheng zhi rong you xian gong si	319
福建钦龙食品有限公司	fu jian qin long shi pin you xian gong si	209
福建青拓镍业有限公司	fu jian qing tuo nie ye you xian gong si	226
福建瑞峰革业有限公司	fu jian rui feng ge ye you xian gong si	132
福建瑞鑫铸造有限公司	fu jian rui xin zhu zao you xian gong si	191
福建三铭胶业有限公司	fu jian san ming jiao ye you xian gong si	164
福建上建水泥有限公司	fu jian shang jian shui ni you xian gong si	204
福建申达钢铁有限公司	fu jian shen da gang tie you xian gong si	157
福建省白马军联工贸有限公司	fu jian sheng bai ma jun lian gong mao you xian gong si	103
福建省长汀县第一建筑有限公司	fu jian sheng chang ting xian di yi jian zhu you xian gong si	296
福建省第一公路工程有限公司	fu jian sheng di yi gong lu gong cheng you xian gong si	299
福建省福安市中澳机电有限公司	fu jian sheng fu an shi zhong ao ji dian you xian gong si	45
福建省福丰实业有限公司码头	fu jian sheng fu feng shi ye you xian gong si ma tou	236
福建省福宁特种钢有限公司	fu jian sheng fu ning te zhong gang you xian gong si	85
福建省高速养护工程有限公司	fu jian sheng gao su yang hu gong cheng you xian gong si	307
福建省古田县华强特钢有限公司	fu jian sheng gu tian xian hua qiang te gang you xian gong si	253
福建省广福茶叶有限责任公司	fu jian sheng guang fu cha ye you xian ze ren gong si	83
福建省恒辉金属制品有限公司	fu jian sheng heng hui jin shu zhi pin you xian gong si	141
福建省建力造船有限公司	fu jian sheng jian li zao chuan you xian gong si	153
福建省立新船舶工程有限公司	fu jian sheng li xin chuan bo gong cheng you xian gong si	147
福建省美特合成革有限公司	fu jian sheng mei te he cheng ge you xian gong si	225
福建省南阳码头有限公司	fu jian sheng nan yang ma tou you xian gong si	263
福建省南阳食品有限公司	fu jian sheng nan yang shi pin you xian gong si	182
福建省宁德市华港饲料有限公司	fu jian sheng ning de shi hua gang si liao you xian gong si	310
福建省屏南榕屏化工有限公司	fu jian sheng ping nan rong ping hua gong you xian gong si	317
福建省强宏工业气体有限公司	fu jian sheng qiang hong gong ye qi ti you xian gong si	174
福建省腾高管业有限公司	fu jian sheng teng gao guan ye you xian gong si	301
福建省祥安纸业有限公司	fu jian sheng xiang an zhi ye you xian gong si	102
福建省银象电器有限公司	fu jian sheng yin xiang dian qi you xian gong si	61
福建省中南燃料有限公司	fu jian sheng zhong nan ran liao you xian gong si	283
福建省中正工贸实业有限公司	fu jian sheng zhong zheng gong mao shi ye you xian gong si	218
福建泰华石化有限公司	fu jian tai hua shi hua you xian gong si	100
福建太平洋植绒有限公司	fu jian tai ping yang zhi rong you xian gong si	200
福建泰盛石化有限公司	fu jian tai sheng shi hua you xian gong si	220
福建天宝模具材料有限公司	fu jian tian bao mu ju cai liao you xian gong si	233
福建天工电机有限公司	fu jian tian gong dian ji you xian gong si	59
福建天弘合成革有限公司	fu jian tian hong he cheng ge you xian gong si	114
福建天盛油脂化工有限公司	fu jian tian sheng you zhi hua gong you xian gong si	203
福建铁王精密铸造有限公司	fu jian tie wang jing mi zhu zao you xian gong si	256
福建同辉机电设备有限公司	fu jian tong hui ji dian she bei you xian gong si	150
福建万达电机有限公司	fu jian wan da dian ji you xian gong si	42
福建万丰革业有限公司	fu jian wan feng ge ye you xian gong si	118
福建伟邦聚合材料有限公司	fu jian wei bang ju he cai liao you xian gong si	161
福建祥大利合成革实业有限公司	fu jian xiang da li he cheng ge shi ye you xian gong si	235
福建谐美皮革有限公司	fu jian xie mei pi ge you xian gong si	111
福建信昌造船有限责任公司	fu jian xin chang zao chuan you xian ze ren gong si	140
福建新时尚新型建材有限公司	fu jian xin shi shang xin xing jian cai you xian gong si	288
福建兴华贸易有限公司	fu jian xing hua mao yi you xian gong si	304
福建星泰合成革有限公司	fu jian xing tai he cheng ge you xian gong si	127
福建亚达隆电机有限公司	fu jian ya da long dian ji you xian gong si	44
福建燕京惠泉啤酒福鼎有限公司	fu jian yan jing hui quan pi jiu fu ding you xian gong si	216
福建一格铸业有限公司	fu jian yi ge zhu ye you xian gong si	194
福建益隆电机有限公司	fu jian yi long dian ji you xian gong si	17
福建永宝特钢阀门有限公司	fu jian yong bao te gang fa men you xian gong si	155
福建永昌盛合成革有限公司	fu jian yong chang sheng he cheng ge you xian gong si	320
福建永大阀门制造有限公司	fu jian yong da fa men zhi zao you xian gong si	148
福建永得利合成革有限公司	fu jian yong de li he cheng ge you xian gong si	107
福建永丰合成革有限公司	fu jian yong feng he cheng ge you xian gong si	243
福建永固混凝土有限公司	fu jian yong gu hun ning tu you xian gong si	158
福建永惠电机有限公司	fu jian yong hui dian ji you xian gong si	5
福建永泰安合成革有限公司	fu jian yong tai an he cheng ge you xian gong si	113
福建有氟密泵阀有限公司	fu jian you fu mi beng fa you xian gong si	324
福建裕发合成革实业有限公司	fu jian yu fa he cheng ge shi ye you xian gong si	223
福建煜升超纤有限公司	fu jian yu sheng chao xian you xian gong si	241
福建源大顺贸易有限公司	fu jian yuan da shun mao yi you xian gong si	49
福建元发树脂有限公司	fu jian yuan fa shu zhi you xian gong si	202
福建正大利超纤革业有限公司	fu jian zheng da li chao xian ge ye you xian gong si	237
福建正德有机板材有限公司	fu jian zheng de you ji ban cai you xian gong si	184
福建正丰建材实业有限公司	fu jian zheng feng jian cai shi ye you xian gong si	279
福建正利发合成革实业有限公司	fu jian zheng li fa he cheng ge shi ye you xian gong si	314
福建正利发树脂有限公司	fu jian zheng li fa shu zhi you xian gong si	119
福建正裕利合成革有限公司	fu jian zheng yu li he cheng ge you xian gong si	108
福州保税区天利达贸易有限公司	fu zhou bao shui qu tian li da mao yi you xian gong si	166
福州星光德邦物流有限公司	fu zhou xing guang de bang wu liu you xian gong si	208
古田福兴医药有限公司	gu tian fu xing yi yao you xian gong si	316
古田县城东街道西山村地磅站	gu tian xian cheng dong jie dao xi shan cun di bang zhan	254
古田县方鑫建材有限公司	gu tian xian fang xin jian cai you xian gong si	143
古田县凤都刘国铸地磅点	gu tian xian feng du liu guo zhu di bang dian	255
古田县鹤塘镇陈大捷地磅站	gu tian xian he tang zhen chen da jie di bang zhan	257
古田县丽富胶合板厂	gu tian xian li fu jiao he ban chang	142
古田县亿源混凝土有限公司	gu tian xian yi yuan hun ning tu you xian gong si	144
恒晟福建物资有限公司	heng sheng fu jian wu zi you xian gong si	245
华业福建电机有限公司	hua ye fu jian dian ji you xian gong si	27
凯捷利集团有限公司	kai jie li ji tuan you xian gong si	34
联港金属制品福建有限公司	lian gang jin shu zhi pin fu jian you xian gong si	341
美华丰建材福建有限公司	mei hua feng jian cai fu jian you xian gong si	284
闽东丛贸船舶实业有限公司	min dong cong mao chuan bo shi ye you xian gong si	217
闽东电机寿宁有限公司	min dong dian ji shou ning you xian gong si	139
宁德核电有限公司	ning de he dian you xian gong si	313
宁德恒信实业有限公司	ning de heng xin shi ye you xian gong si	198
宁德集发建材有限公司	ning de ji fa jian cai you xian gong si	228
宁德市葆谊金属制品有限公司	ning de shi bao yi jin shu zhi pin you xian gong si	339
宁德市常富建材有限公司	ning de shi chang fu jian cai you xian gong si	302
宁德市储备粮管理有限公司	ning de shi chu bei liang guan li you xian gong si	229
宁德市大裕精密铸造有限公司	ning de shi da yu jing mi zhu zao you xian gong si	275
宁德时代投资有限公司	ning de shi dai tou zi you xian gong si	342
宁德市恒生物资有限公司	ning de shi heng sheng wu zi you xian gong si	258
宁德市蕉城区黄学朴地磅点	ning de shi jiao cheng qu huang xue pu di bang dian	168
宁德市蕉城区金涵十八岭停车场	ning de shi jiao cheng qu jin han shi ba ling ting che chang	262
宁德市金顺纸业有限公司	ning de shi jin shun zhi ye you xian gong si	151
宁德市京嘉米业有限公司	ning de shi jing jia mi ye you xian gong si	259
宁德市利源新型建材有限公司	ning de shi li yuan xin xing jian cai you xian gong si	101
宁德市南阳饲料有限公司	ning de shi nan yang si liao you xian gong si	265
宁德市钳固建材有限责任公司	ning de shi qian gu jian cai you xian ze ren gong si	185
宁德市盛丰物资贸易有限公司	ning de shi sheng feng wu zi mao yi you xian gong si	167
宁德市顺通物流有限公司	ning de shi shun tong wu liu you xian gong si	250
宁德市通日新型建材有限公司	ning de shi tong ri xin xing jian cai you xian gong si	213
宁德市祥全工贸有限公司	ning de shi xiang quan gong mao you xian gong si	173
宁德市鑫森化工有限公司	ning de shi xin sen hua gong you xian gong si	264
宁德市鑫宇不锈钢有限公司	ning de shi xin yu bu xiu gang you xian gong si	248
宁德市亿力电力设备有限公司	ning de shi yi li dian li she bei you xian gong si	326
宁德市银宏工贸有限公司	ning de shi yin hong gong mao you xian gong si	289
宁德市远藤食品有限公司	ning de shi yuan teng shi pin you xian gong si	261
宁德市漳湾集装箱有限公司	ning de shi zhang wan ji zhuang xiang you xian gong si	134
宁德市纵横陶瓷原料有限公司	ning de shi zong heng tao ci yuan liao you xian gong si	133
宁德特波电机有限公司	ning de te bo dian ji you xian gong si	309
宁德希优亿电机有限公司	ning de xi you yi dian ji you xian gong si	70
宁德艺鑫工贸有限公司	ning de yi xin gong mao you xian gong si	207
宁德盈德气体有限公司	ning de ying de qi ti you xian gong si	99
宁德漳湾垃圾焚烧发电有限公司	ning de zhang wan la ji fen shao fa dian you xian gong si	340
屏南华田竹木制品有限公司	ping nan hua tian zhu mu zhi pin you xian gong si	251
屏南万润金属有限公司	ping nan wan run jin shu you xian gong si	249
屏南县宝富玻璃工艺有限公司	ping nan xian bao fu bo li gong yi you xian gong si	252
屏南县宝兴银矿	ping nan xian bao xing yin kuang	88
屏南县陈福清地磅点	ping nan xian chen fu qing di bang dian	211
屏南县锦源竹木制品有限公司	ping nan xian jin yuan zhu mu zhi pin you xian gong si	178
屏南县三宇竹制品厂	ping nan xian san yu zhu zhi pin chang	89
屏南县圣阳矿业有限公司	ping nan xian sheng yang kuang ye you xian gong si	135
屏南县永锋混凝土搅拌有限公司	ping nan xian yong feng hun ning tu jiao ban you xian gong si	329
屏南县众鑫矿业有限公司	ping nan xian zhong xin kuang ye you xian gong si	90
强力管桩宁德有限公司	qiang li guan zhuang ning de you xian gong si	206
荣兴福建特种钢业有限公司	rong xing fu jian te zhong gang ye you xian gong si	267
三禾电气福建有限公司	san he dian qi fu jian you xian gong si	287
三祥新材股份有限公司	san xiang xin cai gu fen you xian gong si	278
上海新艺佳物业有限公司	shang hai xin yi jia wu ye you xian gong si	344
寿宁县富鑫铸件厂	shou ning xian fu xin zhu jian chang	274
寿宁县亘生金属有限公司	shou ning xian gen sheng jin shu you xian gong si	276
寿宁县宏辉铸件厂	shou ning xian hong hui zhu jian chang	271
寿宁县宏建铸件厂	shou ning xian hong jian zhu jian chang	270
寿宁县宏裕铸造厂	shou ning xian hong yu zhu zao chang	189
寿宁县华普钛业有限公司	shou ning xian hua pu tai ye you xian gong si	98
寿宁县金泰金属有限公司	shou ning xian jin tai jin shu you xian gong si	192
寿宁县利民铸件厂	shou ning xian li min zhu jian chang	272
寿宁县南阳镇洋边秀洋碓过磅点	shou ning xian nan yang zhen yang bian xiu yang dui guo bang dian	190
寿宁县强盛纸业有限公司	shou ning xian qiang sheng zhi ye you xian gong si	188
寿宁县荣华金属制品有限公司	shou ning xian rong hua jin shu zhi pin you xian gong si	315
寿宁县三峰精密铸造有限公司	shou ning xian san feng jing mi zhu zao you xian gong si	269
寿宁县盛辉生猪养殖有限公司	shou ning xian sheng hui sheng zhu yang zhi you xian gong si	97
寿宁县信达特种橡胶有限公司	shou ning xian xin da te zhong xiang jiao you xian gong si	193
寿宁县兴顺铸造有限公司	shou ning xian xing shun zhu zao you xian gong si	277
寿宁县星耀气体有限公司	shou ning xian xing yao qi ti you xian gong si	273
万里电机福建有限公司	wan li dian ji fu jian you xian gong si	39
霞浦宏昌拆船有限公司	xia pu hong chang chai chuan you xian gong si	163
霞浦县长春地磅站	xia pu xian chang chun di bang zhan	335
霞浦县粮食购销有限公司	xia pu xian liang shi gou xiao you xian gong si	306
霞浦县绿缘农牧发展有限公司	xia pu xian lv yuan nong mu fa zhan you xian gong si	86
霞浦县闽鸿新型建材有限公司	xia pu xian min hong xin xing jian cai you xian gong si	291
霞浦县沙江南屏过磅点	xia pu xian sha jiang nan ping guo bang dian	280
霞浦县晟森木业有限公司	xia pu xian sheng sen mu ye you xian gong si	336
霞浦县松港长沙邱德桂地磅站	xia pu xian song gang chang sha qiu de gui di bang zhan	162
霞浦县同兴贸易公司	xia pu xian tong xing mao yi gong si	180
霞浦县下浒言斌电子过磅点	xia pu xian xia hu yan bin dian zi guo bang dian	222
霞浦县下浒永安电子过磅点	xia pu xian xia hu yong an dian zi guo bang dian	221
霞浦县祥铃煤渣加工厂	xia pu xian xiang ling mei zha jia gong chang	290
霞浦县牙城敖松苍	xia pu xian ya cheng ao song cang	84
霞浦县永兴水产工贸有限公司	xia pu xian yong xing shui chan gong mao you xian gong si	159
霞浦众兴农牧专业合作社	xia pu zhong xing nong mu zhuan ye he zuo she	292
远东电机宁德有限公司	yuan dong dian ji ning de you xian gong si	308
柘荣县垃圾处理场建设指挥部	zhe rong xian la ji chu li chang jian she zhi hui bu	332
柘荣县鑫鑫养殖场	zhe rong xian xin xin yang zhi chang	87
柘荣兴利达铸造有限公司	zhe rong xing li da zhu zao you xian gong si	212
正泰福建电机有限公司	zheng tai fu jian dian ji you xian gong si	18
中核华兴宁德核电项目部	zhong he hua xing ning de he dian xiang mu bu	325
中建四局第六建筑工程有限公司	zhong jian si ju di liu jian zhu gong cheng you xian gong si	312
中交四航局第二工程有限公司	zhong jiao si hang ju di er gong cheng you xian gong si	322
中交一公局第六工程有限公司	zhong jiao yi gong ju di liu gong cheng you xian gong si	330
周宁南洋建材搅拌站	zhou ning nan yang jian cai jiao ban zhan	183
周宁县金丰矿业有限公司	zhou ning xian jin feng kuang ye you xian gong si	171
周宁县龙潭工业区地磅	zhou ning xian long tan gong ye qu di bang	177
周宁县绿力茶叶有限公司	zhou ning xian lv li cha ye you xian gong si	170
周宁县七步镇康达钢业有限公司	zhou ning xian qi bu zhen kang da gang ye you xian gong si	172
周宁县顺通工贸有限公司	zhou ning xian shun tong gong mao you xian gong si	328
周宁县万旗矿业开发有限公司	zhou ning xian wan qi kuang ye kai fa you xian gong si	179
