# 文件名：宣威市地名.scel
# 词库名：宣威市地名
# 词库分类：行政区划地名
# 词库描述：
# 词条样例：宣威市阿都乡大佐村 宣威市阿都乡银厂村 宣威市阿都乡增坪村 宣威市阿都乡阿都村 宣威市板桥镇耿屯村
# 词条数量：353

宣威市阿都乡阿都村	xuan wei shi a dou xiang a dou cun	353
宣威市阿都乡大佐村	xuan wei shi a dou xiang da zuo cun	352
宣威市阿都乡发吉村	xuan wei shi a dou xiang fa ji cun	351
宣威市阿都乡谷兴村	xuan wei shi a dou xiang gu xing cun	350
宣威市阿都乡合庆村	xuan wei shi a dou xiang he qing cun	349
宣威市阿都乡姜棚村	xuan wei shi a dou xiang jiang peng cun	348
宣威市阿都乡梨树村	xuan wei shi a dou xiang li shu cun	347
宣威市阿都乡荣胜村	xuan wei shi a dou xiang rong sheng cun	346
宣威市阿都乡施都村	xuan wei shi a dou xiang shi dou cun	345
宣威市阿都乡同兴村	xuan wei shi a dou xiang tong xing cun	344
宣威市阿都乡银厂村	xuan wei shi a dou xiang yin chang cun	343
宣威市阿都乡增坪村	xuan wei shi a dou xiang zeng ping cun	342
宣威市板桥镇板桥村	xuan wei shi ban qiao zhen ban qiao cun	341
宣威市板桥镇东屯村	xuan wei shi ban qiao zhen dong tun cun	340
宣威市板桥镇歌乐村	xuan wei shi ban qiao zhen ge le cun	339
宣威市板桥镇耿屯村	xuan wei shi ban qiao zhen geng tun cun	338
宣威市板桥镇龙津村	xuan wei shi ban qiao zhen long jin cun	337
宣威市板桥镇木乃村	xuan wei shi ban qiao zhen mu nai cun	336
宣威市板桥镇石缸村	xuan wei shi ban qiao zhen shi gang cun	335
宣威市板桥镇土城村	xuan wei shi ban qiao zhen tu cheng cun	334
宣威市板桥镇西边村	xuan wei shi ban qiao zhen xi bian cun	333
宣威市板桥镇下村村	xuan wei shi ban qiao zhen xia cun cun	332
宣威市板桥镇鸭塘村	xuan wei shi ban qiao zhen ya tang cun	331
宣威市板桥镇永安村	xuan wei shi ban qiao zhen yong an cun	330
宣威市板桥镇庄子村	xuan wei shi ban qiao zhen zhuang zi cun	329
宣威市宝山镇安益村	xuan wei shi bao shan zhen an yi cun	328
宣威市宝山镇白戛村	xuan wei shi bao shan zhen bai jia cun	327
宣威市宝山镇包村	xuan wei shi bao shan zhen bao cun	326
宣威市宝山镇宝山村	xuan wei shi bao shan zhen bao shan cun	325
宣威市宝山镇被古村	xuan wei shi bao shan zhen bei gu cun	324
宣威市宝山镇厂房村	xuan wei shi bao shan zhen chang fang cun	323
宣威市宝山镇德积村	xuan wei shi bao shan zhen de ji cun	322
宣威市宝山镇得马田村	xuan wei shi bao shan zhen de ma tian cun	321
宣威市宝山镇海西村	xuan wei shi bao shan zhen hai xi cun	320
宣威市宝山镇虎场村	xuan wei shi bao shan zhen hu chang cun	319
宣威市宝山镇戛立村	xuan wei shi bao shan zhen jia li cun	313
宣威市宝山镇乐红村	xuan wei shi bao shan zhen le hong cun	318
宣威市宝山镇摩布村	xuan wei shi bao shan zhen mo bu cun	317
宣威市宝山镇摩戛村	xuan wei shi bao shan zhen mo jia cun	316
宣威市宝山镇太和村	xuan wei shi bao shan zhen tai he cun	315
宣威市宝山镇塘子村	xuan wei shi bao shan zhen tang zi cun	314
宣威市得禄乡大营村	xuan wei shi de lu xiang da ying cun	312
宣威市得禄乡得禄村	xuan wei shi de lu xiang de lu cun	311
宣威市得禄乡迭那村	xuan wei shi de lu xiang die na cun	310
宣威市得禄乡肥谷村	xuan wei shi de lu xiang fei gu cun	309
宣威市得禄乡河艾村	xuan wei shi de lu xiang he ai cun	308
宣威市得禄乡色空村	xuan wei shi de lu xiang se kong cun	307
宣威市得禄乡务乐村	xuan wei shi de lu xiang wu le cun	306
宣威市得禄乡小营村	xuan wei shi de lu xiang xiao ying cun	305
宣威市得禄乡永乐村	xuan wei shi de lu xiang yong le cun	304
宣威市得禄乡志度村	xuan wei shi de lu xiang zhi du cun	303
宣威市东山镇安迪村	xuan wei shi dong shan zhen an di cun	302
宣威市东山镇八大河村	xuan wei shi dong shan zhen ba da he cun	301
宣威市东山镇赤那河村	xuan wei shi dong shan zhen chi na he cun	299
宣威市东山镇法着村	xuan wei shi dong shan zhen fa zhe cun	298
宣威市东山镇芙蓉村	xuan wei shi dong shan zhen fu rong cun	281
宣威市东山镇歌可村	xuan wei shi dong shan zhen ge ke cun	297
宣威市东山镇格木村	xuan wei shi dong shan zhen ge mu cun	296
宣威市东山镇海那村	xuan wei shi dong shan zhen hai na cun	295
宣威市东山镇火石盆村	xuan wei shi dong shan zhen huo shi pen cun	294
宣威市东山镇卡基村	xuan wei shi dong shan zhen ka ji cun	293
宣威市东山镇老营村	xuan wei shi dong shan zhen lao ying cun	292
宣威市东山镇李家村	xuan wei shi dong shan zhen li jia cun	291
宣威市东山镇马场村	xuan wei shi dong shan zhen ma chang cun	290
宣威市东山镇米乐村	xuan wei shi dong shan zhen mi le cun	289
宣威市东山镇坪子村	xuan wei shi dong shan zhen ping zi cun	288
宣威市东山镇恰德村	xuan wei shi dong shan zhen qia de cun	287
宣威市东山镇三乐村	xuan wei shi dong shan zhen san le cun	286
宣威市东山镇瓦路村	xuan wei shi dong shan zhen wa lu cun	285
宣威市东山镇协法村	xuan wei shi dong shan zhen xie fa cun	284
宣威市东山镇朝阳村	xuan wei shi dong shan zhen zhao yang cun	300
宣威市东山镇镇雄村	xuan wei shi dong shan zhen zhen xiong cun	283
宣威市东山镇朱家湾村	xuan wei shi dong shan zhen zhu jia wan cun	282
宣威市格宜镇白泥村	xuan wei shi ge yi zhen bai ni cun	280
宣威市格宜镇翠华村	xuan wei shi ge yi zhen cui hua cun	279
宣威市格宜镇大坪村	xuan wei shi ge yi zhen da ping cun	278
宣威市格宜镇大兴村	xuan wei shi ge yi zhen da xing cun	277
宣威市格宜镇得马村	xuan wei shi ge yi zhen de ma cun	276
宣威市格宜镇法戛村	xuan wei shi ge yi zhen fa jia cun	275
宣威市格宜镇华泽村	xuan wei shi ge yi zhen hua ze cun	274
宣威市格宜镇龙泉村	xuan wei shi ge yi zhen long quan cun	273
宣威市格宜镇龙山村	xuan wei shi ge yi zhen long shan cun	272
宣威市格宜镇陆村村	xuan wei shi ge yi zhen lu cun cun	271
宣威市格宜镇米茂村	xuan wei shi ge yi zhen mi mao cun	270
宣威市格宜镇启文村	xuan wei shi ge yi zhen qi wen cun	269
宣威市格宜镇石磨村	xuan wei shi ge yi zhen shi mo cun	268
宣威市格宜镇早稻村	xuan wei shi ge yi zhen zao dao cun	267
宣威市海岱镇大栗树村	xuan wei shi hai dai zhen da li shu cun	266
宣威市海岱镇代坪村	xuan wei shi hai dai zhen dai ping cun	265
宣威市海岱镇德来村	xuan wei shi hai dai zhen de lai cun	264
宣威市海岱镇顾湾村	xuan wei shi hai dai zhen gu wan cun	263
宣威市海岱镇箐头村	xuan wei shi hai dai zhen jing tou cun	251
宣威市海岱镇腊谷村	xuan wei shi hai dai zhen la gu cun	262
宣威市海岱镇乐所村	xuan wei shi hai dai zhen le suo cun	261
宣威市海岱镇鲁河村	xuan wei shi hai dai zhen lu he cun	260
宣威市海岱镇密德村	xuan wei shi hai dai zhen mi de cun	259
宣威市海岱镇磨戛村	xuan wei shi hai dai zhen mo jia cun	258
宣威市海岱镇鼠场村	xuan wei shi hai dai zhen shu chang cun	257
宣威市海岱镇水坪村	xuan wei shi hai dai zhen shui ping cun	256
宣威市海岱镇文阁村	xuan wei shi hai dai zhen wen ge cun	255
宣威市海岱镇岩上村	xuan wei shi hai dai zhen yan shang cun	254
宣威市海岱镇羊场村	xuan wei shi hai dai zhen yang chang cun	253
宣威市海岱镇月亮田村	xuan wei shi hai dai zhen yue liang tian cun	252
宣威市虹桥街道北云村	xuan wei shi hong qiao jie dao bei yun cun	250
宣威市虹桥街道虹桥村	xuan wei shi hong qiao jie dao hong qiao cun	249
宣威市虹桥街道马房村	xuan wei shi hong qiao jie dao ma fang cun	248
宣威市虹桥街道月牙村	xuan wei shi hong qiao jie dao yue ya cun	247
宣威市来宾镇大屯村	xuan wei shi lai bin zhen da tun cun	246
宣威市来宾镇观云村	xuan wei shi lai bin zhen guan yun cun	245
宣威市来宾镇河东村	xuan wei shi lai bin zhen he dong cun	244
宣威市来宾镇后夸村	xuan wei shi lai bin zhen hou kua cun	243
宣威市来宾镇虎头村	xuan wei shi lai bin zhen hu tou cun	242
宣威市来宾镇来宾村	xuan wei shi lai bin zhen lai bin cun	241
宣威市来宾镇龙洞村	xuan wei shi lai bin zhen long dong cun	240
宣威市来宾镇盘龙村	xuan wei shi lai bin zhen pan long cun	239
宣威市来宾镇普仓村	xuan wei shi lai bin zhen pu cang cun	238
宣威市来宾镇所乐村	xuan wei shi lai bin zhen suo le cun	237
宣威市来宾镇新田村	xuan wei shi lai bin zhen xin tian cun	236
宣威市来宾镇徐屯村	xuan wei shi lai bin zhen xu tun cun	235
宣威市来宾镇朱屯村	xuan wei shi lai bin zhen zhu tun cun	234
宣威市来宾镇宗范村	xuan wei shi lai bin zhen zong fan cun	233
宣威市乐丰乡邓村村	xuan wei shi le feng xiang deng cun cun	232
宣威市乐丰乡店子村	xuan wei shi le feng xiang dian zi cun	231
宣威市乐丰乡姑着村	xuan wei shi le feng xiang gu zhe cun	230
宣威市乐丰乡建文村	xuan wei shi le feng xiang jian wen cun	229
宣威市乐丰乡乐丰村	xuan wei shi le feng xiang le feng cun	228
宣威市乐丰乡明德村	xuan wei shi le feng xiang ming de cun	227
宣威市乐丰乡前吉村	xuan wei shi le feng xiang qian ji cun	226
宣威市乐丰乡三联村	xuan wei shi le feng xiang san lian cun	225
宣威市乐丰乡色官村	xuan wei shi le feng xiang se guan cun	224
宣威市乐丰乡水炉村	xuan wei shi le feng xiang shui lu cun	223
宣威市乐丰乡团结村	xuan wei shi le feng xiang tuan jie cun	222
宣威市乐丰乡新村村	xuan wei shi le feng xiang xin cun cun	221
宣威市乐丰乡新德村	xuan wei shi le feng xiang xin de cun	220
宣威市乐丰乡新月村	xuan wei shi le feng xiang xin yue cun	219
宣威市龙场镇阿直村	xuan wei shi long chang zhen a zhi cun	218
宣威市龙场镇得所村	xuan wei shi long chang zhen de suo cun	217
宣威市龙场镇黄村村	xuan wei shi long chang zhen huang cun cun	216
宣威市龙场镇旧营村	xuan wei shi long chang zhen jiu ying cun	215
宣威市龙场镇乐树村	xuan wei shi long chang zhen le shu cun	214
宣威市龙场镇联丰村	xuan wei shi long chang zhen lian feng cun	213
宣威市龙场镇龙场村	xuan wei shi long chang zhen long chang cun	212
宣威市龙场镇龙林村	xuan wei shi long chang zhen long lin cun	211
宣威市龙场镇隆庄村	xuan wei shi long chang zhen long zhuang cun	210
宣威市龙场镇罗营村	xuan wei shi long chang zhen luo ying cun	209
宣威市龙场镇勺姑村	xuan wei shi long chang zhen shao gu cun	208
宣威市龙场镇五里村	xuan wei shi long chang zhen wu li cun	207
宣威市龙场镇志戛村	xuan wei shi long chang zhen zhi jia cun	206
宣威市龙潭镇茨德村	xuan wei shi long tan zhen ci de cun	205
宣威市龙潭镇大坡村	xuan wei shi long tan zhen da po cun	203
宣威市龙潭镇打乌村	xuan wei shi long tan zhen da wu cun	204
宣威市龙潭镇得基村	xuan wei shi long tan zhen de ji cun	202
宣威市龙潭镇放马坪村	xuan wei shi long tan zhen fang ma ping cun	201
宣威市龙潭镇龙潭村	xuan wei shi long tan zhen long tan cun	200
宣威市龙潭镇陆泉村	xuan wei shi long tan zhen lu quan cun	199
宣威市龙潭镇磨石村	xuan wei shi long tan zhen mo shi cun	198
宣威市龙潭镇上格村	xuan wei shi long tan zhen shang ge cun	197
宣威市龙潭镇下格村	xuan wei shi long tan zhen xia ge cun	196
宣威市龙潭镇新河村	xuan wei shi long tan zhen xin he cun	195
宣威市龙潭镇新茂村	xuan wei shi long tan zhen xin mao cun	194
宣威市龙潭镇新坪村	xuan wei shi long tan zhen xin ping cun	193
宣威市龙潭镇新启村	xuan wei shi long tan zhen xin qi cun	192
宣威市龙潭镇业肥村	xuan wei shi long tan zhen ye fei cun	191
宣威市龙潭镇营上村	xuan wei shi long tan zhen ying shang cun	190
宣威市龙潭镇中岭子村	xuan wei shi long tan zhen zhong ling zi cun	189
宣威市落水镇滴水村	xuan wei shi luo shui zhen di shui cun	188
宣威市落水镇多乐村	xuan wei shi luo shui zhen duo le cun	187
宣威市落水镇海子村	xuan wei shi luo shui zhen hai zi cun	186
宣威市落水镇黄路村	xuan wei shi luo shui zhen huang lu cun	185
宣威市落水镇灰硐村	xuan wei shi luo shui zhen hui dong cun	184
宣威市落水镇火石村	xuan wei shi luo shui zhen huo shi cun	183
宣威市落水镇落水村	xuan wei shi luo shui zhen luo shui cun	182
宣威市落水镇马图村	xuan wei shi luo shui zhen ma tu cun	181
宣威市落水镇瑞硐村	xuan wei shi luo shui zhen rui dong cun	180
宣威市落水镇三道村	xuan wei shi luo shui zhen san dao cun	179
宣威市普立乡阿基卡村	xuan wei shi pu li xiang a ji ka cun	178
宣威市普立乡簸火村	xuan wei shi pu li xiang bo huo cun	166
宣威市普立乡戈特村	xuan wei shi pu li xiang ge te cun	177
宣威市普立乡格学村	xuan wei shi pu li xiang ge xue cun	176
宣威市普立乡更底村	xuan wei shi pu li xiang geng di cun	175
宣威市普立乡官寨村	xuan wei shi pu li xiang guan zhai cun	174
宣威市普立乡鹤谷村	xuan wei shi pu li xiang he gu cun	173
宣威市普立乡卡乌村	xuan wei shi pu li xiang ka wu cun	172
宣威市普立乡腊龙村	xuan wei shi pu li xiang la long cun	171
宣威市普立乡老厂村	xuan wei shi pu li xiang lao chang cun	170
宣威市普立乡攀枝戛村	xuan wei shi pu li xiang pan zhi jia cun	169
宣威市普立乡普立村	xuan wei shi pu li xiang pu li cun	168
宣威市普立乡迤兴村	xuan wei shi pu li xiang yi xing cun	167
宣威市热水镇阿浪村	xuan wei shi re shui zhen a lang cun	165
宣威市热水镇柏木村	xuan wei shi re shui zhen bai mu cun	164
宣威市热水镇岱海村	xuan wei shi re shui zhen dai hai cun	144
宣威市热水镇得德村	xuan wei shi re shui zhen de de cun	163
宣威市热水镇陡沟村	xuan wei shi re shui zhen dou gou cun	162
宣威市热水镇干海村	xuan wei shi re shui zhen gan hai cun	161
宣威市热水镇格依村	xuan wei shi re shui zhen ge yi cun	160
宣威市热水镇关营村	xuan wei shi re shui zhen guan ying cun	159
宣威市热水镇海德村	xuan wei shi re shui zhen hai de cun	158
宣威市热水镇花鱼村	xuan wei shi re shui zhen hua yu cun	157
宣威市热水镇吉科村	xuan wei shi re shui zhen ji ke cun	156
宣威市热水镇建新村	xuan wei shi re shui zhen jian xin cun	155
宣威市热水镇乐迤村	xuan wei shi re shui zhen le yi cun	154
宣威市热水镇黎山村	xuan wei shi re shui zhen li shan cun	153
宣威市热水镇热水村	xuan wei shi re shui zhen re shui cun	152
宣威市热水镇色卡村	xuan wei shi re shui zhen se ka cun	151
宣威市热水镇述迤村	xuan wei shi re shui zhen shu yi cun	150
宣威市热水镇响宗村	xuan wei shi re shui zhen xiang zong cun	149
宣威市热水镇秧草村	xuan wei shi re shui zhen yang cao cun	148
宣威市热水镇窑上村	xuan wei shi re shui zhen yao shang cun	147
宣威市热水镇营沟村	xuan wei shi re shui zhen ying gou cun	146
宣威市热水镇中村村	xuan wei shi re shui zhen zhong cun cun	145
宣威市双河乡白所村	xuan wei shi shuang he xiang bai suo cun	143
宣威市双河乡大桥村	xuan wei shi shuang he xiang da qiao cun	142
宣威市双河乡葛菇村	xuan wei shi shuang he xiang ge gu cun	141
宣威市双河乡豁嘎村	xuan wei shi shuang he xiang huo ga cun	140
宣威市双河乡尖山村	xuan wei shi shuang he xiang jian shan cun	139
宣威市双河乡梨坪村	xuan wei shi shuang he xiang li ping cun	138
宣威市双河乡新寨村	xuan wei shi shuang he xiang xin zhai cun	137
宣威市双河乡杨村村	xuan wei shi shuang he xiang yang cun cun	136
宣威市双河乡云瑞村	xuan wei shi shuang he xiang yun rui cun	135
宣威市双河乡皂卫村	xuan wei shi shuang he xiang zao wei cun	134
宣威市双龙街道楚圣村	xuan wei shi shuang long jie dao chu sheng cun	133
宣威市双龙街道黉街村	xuan wei shi shuang long jie dao hong jie cun	125
宣威市双龙街道开源村	xuan wei shi shuang long jie dao kai yuan cun	132
宣威市双龙街道龙华村	xuan wei shi shuang long jie dao long hua cun	131
宣威市双龙街道浦山村	xuan wei shi shuang long jie dao pu shan cun	130
宣威市双龙街道双龙村	xuan wei shi shuang long jie dao shuang long cun	129
宣威市双龙街道双圩村	xuan wei shi shuang long jie dao shuang xu cun	128
宣威市双龙街道泰安村	xuan wei shi shuang long jie dao tai an cun	127
宣威市双龙街道左所村	xuan wei shi shuang long jie dao zuo suo cun	126
宣威市倘塘镇贝古村	xuan wei shi tang tang zhen bei gu cun	124
宣威市倘塘镇得宜村	xuan wei shi tang tang zhen de yi cun	123
宣威市倘塘镇东冲村	xuan wei shi tang tang zhen dong chong cun	122
宣威市倘塘镇法宏村	xuan wei shi tang tang zhen fa hong cun	120
宣威市倘塘镇发赛村	xuan wei shi tang tang zhen fa sai cun	121
宣威市倘塘镇旧堡村	xuan wei shi tang tang zhen jiu bao cun	119
宣威市倘塘镇鲁乍村	xuan wei shi tang tang zhen lu zha cun	118
宣威市倘塘镇茂宗村	xuan wei shi tang tang zhen mao zong cun	117
宣威市倘塘镇铺子村	xuan wei shi tang tang zhen pu zi cun	116
宣威市倘塘镇启龙村	xuan wei shi tang tang zhen qi long cun	115
宣威市倘塘镇三岔村	xuan wei shi tang tang zhen san cha cun	114
宣威市倘塘镇松林村	xuan wei shi tang tang zhen song lin cun	113
宣威市倘塘镇倘塘村	xuan wei shi tang tang zhen tang tang cun	112
宣威市倘塘镇新堡村	xuan wei shi tang tang zhen xin bao cun	111
宣威市倘塘镇新乐村	xuan wei shi tang tang zhen xin le cun	110
宣威市倘塘镇兴隆村	xuan wei shi tang tang zhen xing long cun	109
宣威市倘塘镇宜木戛村	xuan wei shi tang tang zhen yi mu jia cun	108
宣威市倘塘镇英阿村	xuan wei shi tang tang zhen ying a cun	107
宣威市田坝镇阿迤村	xuan wei shi tian ba zhen a yi cun	106
宣威市田坝镇红岩村	xuan wei shi tian ba zhen hong yan cun	105
宣威市田坝镇腊家村	xuan wei shi tian ba zhen la jia cun	104
宣威市田坝镇力行村	xuan wei shi tian ba zhen li xing cun	103
宣威市田坝镇联盟村	xuan wei shi tian ba zhen lian meng cun	102
宣威市田坝镇龙家村	xuan wei shi tian ba zhen long jia cun	101
宣威市田坝镇米田村	xuan wei shi tian ba zhen mi tian cun	100
宣威市田坝镇石坝村	xuan wei shi tian ba zhen shi ba cun	99
宣威市田坝镇石塘村	xuan wei shi tian ba zhen shi tang cun	98
宣威市田坝镇四坪村	xuan wei shi tian ba zhen si ping cun	97
宣威市田坝镇田坝村	xuan wei shi tian ba zhen tian ba cun	96
宣威市田坝镇土木村	xuan wei shi tian ba zhen tu mu cun	95
宣威市田坝镇新发村	xuan wei shi tian ba zhen xin fa cun	94
宣威市田坝镇新民村	xuan wei shi tian ba zhen xin min cun	93
宣威市田坝镇中和村	xuan wei shi tian ba zhen zhong he cun	92
宣威市宛水街道丰华村	xuan wei shi wan shui jie dao feng hua cun	91
宣威市宛水街道柳林村	xuan wei shi wan shui jie dao liu lin cun	90
宣威市宛水街道龙泉村	xuan wei shi wan shui jie dao long quan cun	89
宣威市宛水街道宛水村	xuan wei shi wan shui jie dao wan shui cun	88
宣威市宛水街道望城村	xuan wei shi wan shui jie dao wang cheng cun	87
宣威市宛水街道西河村	xuan wei shi wan shui jie dao xi he cun	86
宣威市宛水街道新南村	xuan wei shi wan shui jie dao xin nan cun	85
宣威市宛水街道新文村	xuan wei shi wan shui jie dao xin wen cun	84
宣威市宛水街道学苑村	xuan wei shi wan shui jie dao xue yuan cun	83
宣威市宛水街道祯祥村	xuan wei shi wan shui jie dao zhen xiang cun	82
宣威市文兴乡安乐村	xuan wei shi wen xing xiang an le cun	81
宣威市文兴乡白药村	xuan wei shi wen xing xiang bai yao cun	80
宣威市文兴乡半山村	xuan wei shi wen xing xiang ban shan cun	79
宣威市文兴乡火木村	xuan wei shi wen xing xiang huo mu cun	78
宣威市文兴乡块塔村	xuan wei shi wen xing xiang kuai ta cun	77
宣威市文兴乡马龙村	xuan wei shi wen xing xiang ma long cun	76
宣威市文兴乡米科村	xuan wei shi wen xing xiang mi ke cun	75
宣威市文兴乡庆底村	xuan wei shi wen xing xiang qing di cun	74
宣威市文兴乡瑞庆村	xuan wei shi wen xing xiang rui qing cun	73
宣威市文兴乡塌土村	xuan wei shi wen xing xiang ta tu cun	72
宣威市文兴乡太平村	xuan wei shi wen xing xiang tai ping cun	71
宣威市文兴乡铜店村	xuan wei shi wen xing xiang tong dian cun	70
宣威市文兴乡文兴村	xuan wei shi wen xing xiang wen xing cun	69
宣威市文兴乡着期村	xuan wei shi wen xing xiang zhe qi cun	67
宣威市文兴乡支留村	xuan wei shi wen xing xiang zhi liu cun	68
宣威市务德镇卜嘎村	xuan wei shi wu de zhen bu ga cun	66
宣威市务德镇岔路村	xuan wei shi wu de zhen cha lu cun	65
宣威市务德镇茨嘎村	xuan wei shi wu de zhen ci ga cun	64
宣威市务德镇发图村	xuan wei shi wu de zhen fa tu cun	63
宣威市务德镇嘎姑村	xuan wei shi wu de zhen ga gu cun	62
宣威市务德镇宏爱村	xuan wei shi wu de zhen hong ai cun	61
宣威市务德镇火姑村	xuan wei shi wu de zhen huo gu cun	60
宣威市务德镇糯嘎村	xuan wei shi wu de zhen nuo ga cun	59
宣威市务德镇庆发村	xuan wei shi wu de zhen qing fa cun	58
宣威市务德镇上坪村	xuan wei shi wu de zhen shang ping cun	57
宣威市务德镇庶乐村	xuan wei shi wu de zhen shu le cun	56
宣威市务德镇太阳村	xuan wei shi wu de zhen tai yang cun	55
宣威市务德镇拖克村	xuan wei shi wu de zhen tuo ke cun	54
宣威市务德镇务德村	xuan wei shi wu de zhen wu de cun	53
宣威市务德镇小街村	xuan wei shi wu de zhen xiao jie cun	52
宣威市务德镇新店村	xuan wei shi wu de zhen xin dian cun	51
宣威市务德镇新华村	xuan wei shi wu de zhen xin hua cun	50
宣威市西宁街道赤水村	xuan wei shi xi ning jie dao chi shui cun	49
宣威市西宁街道复兴村	xuan wei shi xi ning jie dao fu xing cun	48
宣威市西宁街道花椒村	xuan wei shi xi ning jie dao hua jiao cun	47
宣威市西宁街道锦西村	xuan wei shi xi ning jie dao jin xi cun	46
宣威市西宁街道靖外村	xuan wei shi xi ning jie dao jing wai cun	45
宣威市西宁街道老堡村	xuan wei shi xi ning jie dao lao bao cun	44
宣威市西宁街道列租村	xuan wei shi xi ning jie dao lie zu cun	43
宣威市西宁街道马街村	xuan wei shi xi ning jie dao ma jie cun	42
宣威市西宁街道洽坡村	xuan wei shi xi ning jie dao qia po cun	41
宣威市西宁街道西苑村	xuan wei shi xi ning jie dao xi yuan cun	40
宣威市西宁街道袁屯村	xuan wei shi xi ning jie dao yuan tun cun	39
宣威市西泽乡戈平村	xuan wei shi xi ze xiang ge ping cun	38
宣威市西泽乡和乐村	xuan wei shi xi ze xiang he le cun	37
宣威市西泽乡和睦村	xuan wei shi xi ze xiang he mu cun	36
宣威市西泽乡建设村	xuan wei shi xi ze xiang jian she cun	35
宣威市西泽乡马戛村	xuan wei shi xi ze xiang ma jia cun	34
宣威市西泽乡睦乐村	xuan wei shi xi ze xiang mu le cun	33
宣威市西泽乡糯着村	xuan wei shi xi ze xiang nuo zhe cun	32
宣威市西泽乡瑞井村	xuan wei shi xi ze xiang rui jing cun	31
宣威市西泽乡石城村	xuan wei shi xi ze xiang shi cheng cun	30
宣威市西泽乡西泽村	xuan wei shi xi ze xiang xi ze cun	29
宣威市西泽乡向阳村	xuan wei shi xi ze xiang xiang yang cun	28
宣威市西泽乡新房村	xuan wei shi xi ze xiang xin fang cun	27
宣威市西泽乡新建村	xuan wei shi xi ze xiang xin jian cun	26
宣威市西泽乡迤必村	xuan wei shi xi ze xiang yi bi cun	25
宣威市西泽乡迤那村	xuan wei shi xi ze xiang yi na cun	24
宣威市羊场镇陈湾村	xuan wei shi yang chang zhen chen wan cun	13
宣威市羊场镇茨营村	xuan wei shi yang chang zhen ci ying cun	12
宣威市羊场镇大松树村	xuan wei shi yang chang zhen da song shu cun	11
宣威市羊场镇大田坝村	xuan wei shi yang chang zhen da tian ba cun	10
宣威市羊场镇多贝戛村	xuan wei shi yang chang zhen duo bei jia cun	9
宣威市羊场镇鸡场村	xuan wei shi yang chang zhen ji chang cun	8
宣威市羊场镇普瓦村	xuan wei shi yang chang zhen pu wa cun	7
宣威市羊场镇清水村	xuan wei shi yang chang zhen qing shui cun	6
宣威市羊场镇兔场村	xuan wei shi yang chang zhen tu chang cun	5
宣威市羊场镇小箐村	xuan wei shi yang chang zhen xiao jing cun	4
宣威市羊场镇英角村	xuan wei shi yang chang zhen ying jiao cun	3
宣威市羊场镇镇新村	xuan wei shi yang chang zhen zhen xin cun	2
宣威市羊场镇宗德村	xuan wei shi yang chang zhen zong de cun	1
宣威市杨柳乡海庆村	xuan wei shi yang liu xiang hai qing cun	23
宣威市杨柳乡和平村	xuan wei shi yang liu xiang he ping cun	22
宣威市杨柳乡蒋箐村	xuan wei shi yang liu xiang jiang jing cun	21
宣威市杨柳乡可渡村	xuan wei shi yang liu xiang ke du cun	20
宣威市杨柳乡克基村	xuan wei shi yang liu xiang ke ji cun	19
宣威市杨柳乡留田村	xuan wei shi yang liu xiang liu tian cun	18
宣威市杨柳乡水塘村	xuan wei shi yang liu xiang shui tang cun	17
宣威市杨柳乡碗厂村	xuan wei shi yang liu xiang wan chang cun	16
宣威市杨柳乡围仗村	xuan wei shi yang liu xiang wei zhang cun	15
宣威市杨柳乡杨柳村	xuan wei shi yang liu xiang yang liu cun	14
