# 文件名：恩施部分地名.scel
# 词库名：恩施部分地名
# 词库分类：行政区划地名
# 词库描述：
# 词条样例：恩施市太阳区财政所 航空大道号 大桥路居委会工龙路 珠山镇卸甲坝村 耿家坪村一组 舞阳办事处凤凰山
# 词条数量：206

笆蕉草子坝	ba jiao cao zi ba	184
芭蕉乡天桥村沙子坡	ba jiao xiang tian qiao cun sha zi po	38
白果乡白果集镇银杏路号	bai guo xiang bai guo ji zhen yin xing lu hao	19
城乡街	cheng xiang jie	198
城乡街学田巷号	cheng xiang jie xue tian xiang hao	199
椿木营乡白果坪村	chun mu ying xiang bai guo ping cun	166
椿木营乡杨柳坨村一组	chun mu ying xiang yang liu tuo cun yi zu	134
椿木营乡长槽村	chun mu ying xiang zhang cao cun	112
椿木营乡长槽村一组	chun mu ying xiang zhang cao cun yi zu	129
崔坝集镇老街崔坝镇农科站	cui ba ji zhen lao jie cui ba zhen nong ke zhan	23
大观园	da guan yuan	62
大桥路二巷	da qiao lu er xiang	75
大桥路号	da qiao lu hao	151
大桥路居委会	da qiao lu ju wei hui	200
大桥路居委会工龙路	da qiao lu ju wei hui gong long lu	196
东风大道号	dong feng da dao hao	149
东风大道号恩施凤凰山畜牧场凤凰山	dong feng da dao hao en shi feng huang shan xu mu chang feng huang shan	100
东风大道号恩施凤凰山畜牧场舞阳办事处凤凰山	dong feng da dao hao en shi feng huang shan xu mu chang wu yang ban shi chu feng huang shan	99
段龙山路号	duan long shan lu hao	190
恩施凤凰小区	en shi feng huang xiao qu	51
恩施市白果乡集镇银杏路号	en shi shi bai guo xiang ji zhen yin xing lu hao	167
恩施市城乡街城乡路	en shi shi cheng xiang jie cheng xiang lu	68
恩施市大桥路二巷号	en shi shi da qiao lu er xiang hao	53
恩施市东风大道号	en shi shi dong feng da dao hao	44
恩施市航空花园号	en shi shi hang kong hua yuan hao	176
恩施市航空路号	en shi shi hang kong lu hao	188
恩施市红庙街	en shi shi hong miao jie	143
恩施市红庙开发区下关田	en shi shi hong miao kai fa qu xia guan tian	49
恩施市红庙下官田	en shi shi hong miao xia guan tian	113
恩施市后山湾号	en shi shi hou shan wan hao	157
恩施市黄泥路号	en shi shi huang ni lu hao	89
恩施市黄泥四组	en shi shi huang ni si zu	66
恩施市机场路	en shi shi ji chang lu	82
恩施市六角亭办事处南门小区	en shi shi liu jiao ting ban shi chu nan men xiao qu	174
恩施市六角亭街道办事处后山湾龙泉小区	en shi shi liu jiao ting jie dao ban shi chu hou shan wan long quan xiao qu	46
恩施市六角亭街道办事处龙鳞宫路	en shi shi liu jiao ting jie dao ban shi chu long lin gong lu	88
恩施市六角亭街道办事处胜利街号	en shi shi liu jiao ting jie dao ban shi chu sheng li jie hao	138
恩施市六角亭街道办事处西门外号	en shi shi liu jiao ting jie dao ban shi chu xi men wai hao	64
恩施市民族东路号	en shi shi min zu dong lu hao	169
恩施市三岔乡集镇大龙路	en shi shi san cha xiang ji zhen da long lu	150
恩施市三岔乡新街	en shi shi san cha xiang xin jie	14
恩施市盛家坝社区居委会	en shi shi sheng jia ba she qu ju wei hui	34
恩施市市府路	en shi shi shi fu lu	137
恩施市市府路号	en shi shi shi fu lu hao	43
恩施市施州大道号	en shi shi shi zhou da dao hao	80
恩施市太阳区财政所	en shi shi tai yang qu cai zheng suo	202
恩施市舞阳大街四巷	en shi shi wu yang da jie si xiang	57
恩施市舞阳街道办事处东风大道号	en shi shi wu yang jie dao ban shi chu dong feng da dao hao	177
恩施市舞阳街道办事处清江东路号	en shi shi wu yang jie dao ban shi chu qing jiang dong lu hao	181
恩施市小渡船办事处大桥路号	en shi shi xiao du chuan ban shi chu da qiao lu hao	130
恩施市小渡船办事处裤裆堰	en shi shi xiao du chuan ban shi chu ku dang yan	178
恩施市小渡船街道办事处红旗小区	en shi shi xiao du chuan jie dao ban shi chu hong qi xiao qu	37
恩施市窑湾村六组	en shi shi yao wan cun liu zu	180
恩施市原轴承厂内	en shi shi yuan zhou cheng chang nei	69
恩施市中山路号	en shi shi zhong shan lu hao	17
恩施小渡船办事处裤裆堰	en shi xiao du chuan ban shi chu ku dang yan	91
风吹垭路号	feng chui ya lu hao	171
凤凰路号	feng huang lu hao	83
冯家槽号	feng jia cao hao	173
高罗集镇建设路	gao luo ji zhen jian she lu	18
耿家坪村一组	geng jia ping cun yi zu	192
工龙路打靶场	gong long lu da ba chang	203
工龙路号	gong long lu hao	125
工农路号	gong nong lu hao	30
工农路三巷	gong nong lu san xiang	11
官坡街号	guan po jie hao	73
广兴路号	guang xing lu hao	145
航空大道	hang kong da dao	155
航空大道号	hang kong da dao hao	201
航空花园号	hang kong hua yuan hao	121
航空花园原纸厂内	hang kong hua yuan yuan zhi chang nei	9
航空路号	hang kong lu hao	144
红庙开发区下关田	hong miao kai fa qu xia guan tian	58
红庙路号	hong miao lu hao	45
红庙下官田	hong miao xia guan tian	168
红庙下管田	hong miao xia guan tian	3
红土乡红土居委会	hong tu xiang hong tu ju wei hui	29
后山湾	hou shan wan	153
后山湾号	hou shan wan hao	78
后山湾阳光花园	hou shan wan yang guang hua yuan	47
黄泥坝村三组	huang ni ba cun san zu	41
黄泥坝村一组	huang ni ba cun yi zu	59
黄泥坝一组	huang ni ba yi zu	76
黄泥村二组	huang ni cun er zu	2
黄泥村一组	huang ni cun yi zu	124
黄泥路一巷号	huang ni lu yi xiang hao	154
建始县业州镇烟墩大道号	jian shi xian ye zhou zhen yan dun da dao hao	72
椒园集镇	jiao yuan ji zhen	52
椒园镇庆阳坝村	jiao yuan zhen qing yang ba cun	21
解放路号	jie fang lu hao	50
金桂大道开发区标准厂方南侧	jin gui da dao kai fa qu biao zhun chang fang nan ce	156
来风县翔凤镇胜利街	lai feng xian xiang feng zhen sheng li jie	140
来凤县翔凤镇渝鄂路	lai feng xian xiang feng zhen yu e lu	158
六角亭后山湾叶挺路	liu jiao ting hou shan wan ye ting lu	105
六角亭街道办事处	liu jiao ting jie dao ban shi chu	92
六角亭街道办事处城乡路号	liu jiao ting jie dao ban shi chu cheng xiang lu hao	147
六角亭街道办事处后山湾	liu jiao ting jie dao ban shi chu hou shan wan	74
六角亭街道办事处解放路	liu jiao ting jie dao ban shi chu jie fang lu	115
六角亭街道办事处头道水村组	liu jiao ting jie dao ban shi chu tou dao shui cun zu	56
六角亭街道办事处西门外号	liu jiao ting jie dao ban shi chu xi men wai hao	133
六角亭街道办事处叶挺路号	liu jiao ting jie dao ban shi chu ye ting lu hao	8
龙凤坝建设路号	long feng ba jian she lu hao	123
龙凤山坡大市场号	long feng shan po da shi chang hao	194
龙凤镇建设路	long feng zhen jian she lu	33
龙凤镇建设路号	long feng zhen jian she lu hao	108
龙凤镇龙马村坊村	long feng zhen long ma cun fang cun	65
龙凤镇三河村白庙组	long feng zhen san he cun bai miao zu	35
龙凤镇响水桥号	long feng zhen xiang shui qiao hao	15
龙鳞宫路号	long lin gong lu hao	97
民族东路二巷号	min zu dong lu er xiang hao	84
民族东路号	min zu dong lu hao	109
民族东路一巷号	min zu dong lu yi xiang hao	13
民族西路	min zu xi lu	206
民族西路号	min zu xi lu hao	42
旗峰大道号	qi feng da dao hao	159
七里坪	qi li ping	204
清江东路号	qing jiang dong lu hao	182
人民路	ren min lu	163
人民路二巷号	ren min lu er xiang hao	6
人民路号	ren min lu hao	162
三岔集镇新街	san cha ji zhen xin jie	114
三岔乡集镇	san cha xiang ji zhen	77
三孔桥	san kong qiao	61
三孔桥路	san kong qiao lu	5
三孔桥园梦庄	san kong qiao yuan meng zhuang	81
三孔桥园梦庄小区	san kong qiao yuan meng zhuang xiao qu	48
三义宫号	san yi gong hao	164
沙道沟镇街上村一组	sha dao gou zhen jie shang cun yi zu	135
沙道镇松坪村组	sha dao zhen song ping cun zu	172
沙地街	sha di jie	40
胜利街号	sheng li jie hao	165
胜利街清江路号	sheng li jie qing jiang lu hao	98
石窑集镇	shi yao ji zhen	28
施州大道	shi zhou da dao	148
施州大道号	shi zhou da dao hao	110
施州大道至机场交叉口	shi zhou da dao zhi ji chang jiao cha kou	26
书院社区	shu yuan she qu	60
水井湾号	shui jing wan hao	39
四维街号	si wei jie hao	183
头道水村	tou dao shui cun	27
头道水村组	tou dao shui cun zu	195
土桥坝段家湾号	tu qiao ba duan jia wan hao	10
土桥坝园梦庄开发小区	tu qiao ba yuan meng zhuang kai fa xiao qu	63
土桥大道二巷号	tu qiao da dao er xiang hao	12
土桥大道号	tu qiao da dao hao	175
土桥街号	tu qiao jie hao	32
土桥街一巷	tu qiao jie yi xiang	197
土桥路号	tu qiao lu hao	31
土司路号	tu si lu hao	126
万寨区大河乡大河村	wan zhai qu da he xiang da he cun	161
万寨乡大坝河村组	wan zhai xiang da ba he cun zu	16
舞阳办事处凤凰山	wu yang ban shi chu feng huang shan	191
舞阳办事处枫香坪村	wu yang ban shi chu feng xiang ping cun	117
舞阳办事处小渡船街道办事处	wu yang ban shi chu xiao du chuan jie dao ban shi chu	122
舞阳办事处沿江路	wu yang ban shi chu yan jiang lu	87
舞阳大道号	wu yang da dao hao	24
舞阳大道一巷号	wu yang da dao yi xiang hao	36
舞阳大街号	wu yang da jie hao	189
舞阳大街三巷号	wu yang da jie san xiang hao	142
舞阳大街一巷号	wu yang da jie yi xiang hao	127
舞阳大街一巷一号沿江路号	wu yang da jie yi xiang yi hao yan jiang lu hao	85
舞阳街道办事处东风大道号	wu yang jie dao ban shi chu dong feng da dao hao	101
舞阳街道办事处凤凰山	wu yang jie dao ban shi chu feng huang shan	93
舞阳街道办事处舞阳大街号	wu yang jie dao ban shi chu wu yang da jie hao	139
舞阳街道舞阳办事处	wu yang jie dao wu yang ban shi chu	141
西正街号胜利街号	xi zheng jie hao sheng li jie hao	54
咸丰县坪坝营村	xian feng xian ping ba ying cun	70
小渡船办事处大桥路	xiao du chuan ban shi chu da qiao lu	90
小渡船办事处裤裆堰	xiao du chuan ban shi chu ku dang yan	118
小渡船办事处旗峰村一组	xiao du chuan ban shi chu qi feng cun yi zu	102
小渡船大桥路号	xiao du chuan da qiao lu hao	170
小渡船街道办事处工农路五巷号	xiao du chuan jie dao ban shi chu gong nong lu wu xiang hao	79
小渡船街道办事处航空路号	xiao du chuan jie dao ban shi chu hang kong lu hao	86
小渡船街道办事处民族东路号	xiao du chuan jie dao ban shi chu min zu dong lu hao	146
小渡船街道办事处旗峰社区	xiao du chuan jie dao ban shi chu qi feng she qu	152
小渡船街道办事处市府路巷	xiao du chuan jie dao ban shi chu shi fu lu xiang	116
晓关乡黄河村	xiao guan xiang huang he cun	20
晓关乡黄河村二十二组	xiao guan xiang huang he cun er shi er zu	7
新建街号	xin jian jie hao	4
新建街原四巷号	xin jian jie yuan si xiang hao	111
宣恩县长潭河乡甘露街号	xuan en xian chang tan he xiang gan lu jie hao	22
宣恩县李家河乡凤山村组	xuan en xian li jia he xiang feng shan cun zu	104
宣恩县万寨乡向家村	xuan en xian wan zhai xiang xiang jia cun	55
宣恩县晓关乡黄和村街上	xuan en xian xiao guan xiang huang he cun jie shang	71
薛家巷六号	xue jia xiang liu hao	179
沿江路	yan jiang lu	205
沿江路凤城小区	yan jiang lu feng cheng xiao qu	96
沿江路号	yan jiang lu hao	103
叶挺路号	ye ting lu hao	132
叶挺路号航空路号	ye ting lu hao hang kong lu hao	107
业州镇人民大道号	ye zhou zhen ren min da dao hao	67
业州镇业州大道号	ye zhou zhen ye zhou da dao hao	128
于舞阳大街号	yu wu yang da jie hao	106
原轴承厂内	yuan zhou cheng chang nei	94
珠山镇白鹤井	zhu shan zhen bai he jing	1
珠山镇黄河巷	zhu shan zhen huang he xiang	136
珠山镇黄河巷号	zhu shan zhen huang he xiang hao	95
珠山镇解放街愿号	zhu shan zhen jie fang jie yuan hao	120
珠山镇莲花坝四组	zhu shan zhen lian hua ba si zu	185
珠山镇民族路号	zhu shan zhen min zu lu hao	25
珠山镇上湖塘村三组	zhu shan zhen shang hu tang cun san zu	186
珠山镇向阳巷	zhu shan zhen xiang yang xiang	131
珠山镇卸甲坝村	zhu shan zhen xie jia ba cun	193
珠山镇兴隆街号	zhu shan zhen xing long jie hao	160
珠山镇兴隆小区	zhu shan zhen xing long xiao qu	119
珠山镇沿河北路	zhu shan zhen yan he bei lu	187
