# 文件名：成都大学名称.scel
# 词库名：成都大学名称
# 词库分类：四川
# 词库描述：
# 词条样例：四川省商业服务学校四川省商贸职业培训学院 成都电大崇州分校 成都电大五冶分校 四川大学水力发电学院 成都电大大邑分校 成都电大青白江分校
# 词条数量：235

成都保险学校	cheng du bao xian xue xiao	209
成都财贸职业学校	cheng du cai mao zhi ye xue xiao	158
成都成人职业学校	cheng du cheng ren zhi ye xue xiao	157
成都大学	cheng du da xue	17
成都德圣中等职业学校	cheng du de sheng zhong deng zhi ye xue xiao	36
成都弟维艺术学校	cheng du di wei yi shu xue xiao	156
成都电大成化分校	cheng du dian da cheng hua fen xiao	229
成都电大崇州分校	cheng du dian da chong zhou fen xiao	233
成都电大大邑分校	cheng du dian da da yi fen xiao	219
成都电大电子分校	cheng du dian da dian zi fen xiao	221
成都电大电子工业分校	cheng du dian da dian zi gong ye fen xiao	222
成都电大龙泉分校	cheng du dian da long quan fen xiao	218
成都电大旅游分校	cheng du dian da lv you fen xiao	228
成都电大青白江分校	cheng du dian da qing bai jiang fen xiao	217
成都电大青羊分校	cheng du dian da qing yang fen xiao	231
成都电大特殊教育分校	cheng du dian da te shu jiao yu fen xiao	226
成都电大温江分校	cheng du dian da wen jiang fen xiao	212
成都电大五冶分校	cheng du dian da wu ye fen xiao	227
成都电大新都分校	cheng du dian da xin du fen xiao	211
成都电大新津分校	cheng du dian da xin jin fen xiao	210
成都电大幼师分校	cheng du dian da you shi fen xiao	220
成都电力职工大学	cheng du dian li zhi gong da xue	125
成都电影电视艺术学校	cheng du dian ying dian shi yi shu xue xiao	155
成都电子机械高等专科学校	cheng du dian zi ji xie gao deng zhuan ke xue xiao	230
成都电子职工大学	cheng du dian zi zhi gong da xue	124
成都发动机公司职工大学	cheng du fa dong ji gong si zhi gong da xue	123
成都纺织高等专科学校	cheng du fang zhi gao deng zhuan ke xue xiao	207
成都纺织工业高等专科学校东校区	cheng du fang zhi gong ye gao deng zhuan ke xue xiao dong xiao qu	208
成都飞机公司工学院	cheng du fei ji gong si gong xue yuan	206
成都公共交通职业学校城北中学	cheng du gong gong jiao tong zhi ye xue xiao cheng bei zhong xue	153
成都工业工程职业培训学院四川工业工程中等专业学校联合办学	cheng du gong ye gong cheng zhi ye pei xun xue yuan si chuan gong ye gong cheng zhong deng zhuan ye xue xiao lian he ban xue	205
成都工业学校	cheng du gong ye xue xiao	154
成都工业职工大学	cheng du gong ye zhi gong da xue	122
成都工业职工大学医药分校	cheng du gong ye zhi gong da xue yi yao fen xiao	204
成都广播电视大学	cheng du guang bo dian shi da xue	121
成都广才中专学校	cheng du guang cai zhong zhuan xue xiao	152
成都航空技术学院	cheng du hang kong ji shu xue yuan	224
成都航空职业技术学院	cheng du hang kong zhi ye ji shu xue yuan	120
成都华夏旅游商务学校	cheng du hua xia lv you shang wu xue xiao	203
成都建设职业中专学校	cheng du jian she zhi ye zhong zhuan xue xiao	151
成都教育局中专	cheng du jiao yu ju zhong zhuan	150
成都教育学院金牛校区	cheng du jiao yu xue yuan jin niu xiao qu	202
成都金沙职业技术学校	cheng du jin sha zhi ye ji shu xue xiao	149
成都经济贸易中专学校	cheng du jing ji mao yi zhong zhuan xue xiao	148
成都经开区职业学校	cheng du jing kai qu zhi ye xue xiao	147
成都军区军医学校	cheng du jun qu jun yi xue xiao	199
成都勘测设计院职工大学	cheng du kan ce she ji yuan zhi gong da xue	198
成都坤林信息管理学校	cheng du kun lin xin xi guan li xue xiao	197
成都理工大学	cheng du li gong da xue	25
成都理工大学广播影视学院	cheng du li gong da xue guang bo ying shi xue yuan	232
成都立信会计学校	cheng du li xin kuai ji xue xiao	225
成都礼仪职业学校	cheng du li yi zhi ye xue xiao	146
成都龙泉职业技术学校	cheng du long quan zhi ye ji shu xue xiao	145
成都陆军学校	cheng du lu jun xue xiao	196
成都旅游职中	cheng du lv you zhi zhong	144
成都农业科技职业学院	cheng du nong ye ke ji zhi ye xue yuan	119
成都神钢工程机械集团有限公司技工学校	cheng du shen gang gong cheng ji xie ji tuan you xian gong si ji gong xue xiao	195
成都市财贸职业高级中学	cheng du shi cai mao zhi ye gao ji zhong xue	191
成都市财贸职业高级中学西区	cheng du shi cai mao zhi ye gao ji zhong xue xi qu	190
成都市财政贸易学校	cheng du shi cai zheng mao yi xue xiao	118
成都市成人教育学院	cheng du shi cheng ren jiao yu xue yuan	189
成都市第四十四中学成都市洞子口职业高级中学	cheng du shi di si shi si zhong xue cheng du shi dong zi kou zhi ye gao ji zhong xue	188
成都市电影电视艺术学校	cheng du shi dian ying dian shi yi shu xue xiao	187
成都市房地产中等专业学校	cheng du shi fang di chan zhong deng zhuan ye xue xiao	143
成都市广播电视大学	cheng du shi guang bo dian shi da xue	117
成都市机电工程学校二校区	cheng du shi ji dian gong cheng xue xiao er xiao qu	186
成都市机电工程学校三校区	cheng du shi ji dian gong cheng xue xiao san xiao qu	185
成都市机电工程学校一校区	cheng du shi ji dian gong cheng xue xiao yi xiao qu	184
成都市礼仪职业中学西区	cheng du shi li yi zhi ye zhong xue xi qu	183
成都市女子职业中学	cheng du shi nv zi zhi ye zhong xue	182
成都市青龙场建筑职中	cheng du shi qing long chang jian zhu zhi zhong	179
成都市青苏职业中专学校	cheng du shi qing su zhi ye zhong zhuan xue xiao	178
成都市人民警察学校	cheng du shi ren min jing cha xue xiao	177
成都市蜀兴职业中学	cheng du shi shu xing zhi ye zhong xue	180
成都市蜀兴职业中专	cheng du shi shu xing zhi ye zhong zhuan	176
成都市西河职业中专学校	cheng du shi xi he zhi ye zhong zhuan xue xiao	142
成都市新都职业技术学校	cheng du shi xin du zhi ye ji shu xue xiao	141
成都实用工程技术学校	cheng du shi yong gong cheng ji shu xue xiao	192
成都市职业大学新都区	cheng du shi zhi ye da xue xin du qu	175
成都师专	cheng du shi zhuan	194
成都蜀兴职业中学	cheng du shu xing zhi ye zhong xue	140
成都水利水电职大	cheng du shui li shui dian zhi da	174
成都棠湖科学技术学校	cheng du tang hu ke xue ji shu xue xiao	139
成都体育学院	cheng du ti yu xue yuan	3
成都天府职业技术学校	cheng du tian fu zhi ye ji shu xue xiao	138
成都铁路技工学校	cheng du tie lu ji gong xue xiao	173
成都铁路卫生学校	cheng du tie lu wei sheng xue xiao	137
成都铁路运输学校	cheng du tie lu yun shu xue xiao	136
成都外语职业中专学校	cheng du wai yu zhi ye zhong zhuan xue xiao	135
成都卫生学校	cheng du wei sheng xue xiao	134
成都文化艺术学校	cheng du wen hua yi shu xue xiao	116
成都文通计算机专业学校	cheng du wen tong ji suan ji zhuan ye xue xiao	172
成都翔飞航空技术学校	cheng du xiang fei hang kong ji shu xue xiao	133
成都新华职业中学	cheng du xin hua zhi ye zhong xue	132
成都信息工程学院航空港	cheng du xin xi gong cheng xue yuan hang kong gang	5
成都信息工程学院龙泉	cheng du xin xi gong cheng xue yuan long quan	6
成都信息工程学院人南	cheng du xin xi gong cheng xue yuan ren nan	7
成都信息工程学院银杏国际饭店管理学院	cheng du xin xi gong cheng xue yuan yin xing guo ji fan dian guan li xue yuan	171
成都信息管理学校西部信息工程学校	cheng du xin xi guan li xue xiao xi bu xin xi gong cheng xue xiao	170
成都畜牧兽医学校	cheng du xu mu shou yi xue xiao	169
成都艺术职业学院	cheng du yi shu zhi ye xue yuan	115
成都医学院	cheng du yi xue yuan	4
成都正则会计学校	cheng du zheng ze kuai ji xue xiao	168
成都指南针计算机学校	cheng du zhi nan zhen ji suan ji xue xiao	114
成都职业技术学院	cheng du zhi ye ji shu xue yuan	131
成都中和职业学校	cheng du zhong he zhi ye xue xiao	130
成都中信职业技术学校	cheng du zhong xin zhi ye ji shu xue xiao	167
成都中医药大学	cheng du zhong yi yao da xue	166
成都中医药大学附属医院针灸学校	cheng du zhong yi yao da xue fu shu yi yuan zhen jiu xue xiao	165
成都中医药大学高新西区校区	cheng du zhong yi yao da xue gao xin xi qu xiao qu	11
成都中医药大学人南校区	cheng du zhong yi yao da xue ren nan xiao qu	12
成都中医药大学十二桥校区	cheng du zhong yi yao da xue shi er qiao xiao qu	8
成都中医药大学汪家拐校区	cheng du zhong yi yao da xue wang jia guai xiao qu	9
成都中医药大学温江校区	cheng du zhong yi yao da xue wen jiang xiao qu	10
川化集团公司技工学校	chuan hua ji tuan gong si ji gong xue xiao	164
川音美术学院	chuan yin mei shu xue yuan	163
大学名称	da xue ming cheng	235
第三军医大学成都军医学院	di san jun yi da xue cheng du jun yi xue yuan	162
电子科大九里堤校区	dian zi ke da jiu li di xiao qu	161
电子科技大学成都学院	dian zi ke ji da xue cheng du xue yuan	113
电子科技大学清水河校区	dian zi ke ji da xue qing shui he xiao qu	29
电子科技大学沙河校区	dian zi ke ji da xue sha he xiao qu	28
国家法官学院	guo jia fa guan xue yuan	159
核工业成都机电学校	he gong ye cheng du ji dian xue xiao	87
湖南金融职大四川教学部	hu nan jin rong zhi da si chuan jiao xue bu	86
华西医大青羊校区	hua xi yi da qing yang xiao qu	85
华友学院	hua you xue yuan	84
昆明陆军学院成都分院	kun ming lu jun xue yuan cheng du fen yuan	83
泸州医学院成都教学部	lu zhou yi xue yuan cheng du jiao xue bu	82
民办四川天一学院	min ban si chuan tian yi xue yuan	112
蜀都学院四川省经济贸易学校中专部	shu dou xue yuan si chuan sheng jing ji mao yi xue xiao zhong zhuan bu	214
四川财经职业学院	si chuan cai jing zhi ye xue yuan	111
四川财政学校	si chuan cai zheng xue xiao	81
四川成都营养师培训学校	si chuan cheng du ying yang shi pei xun xue xiao	129
四川创业学院	si chuan chuang ye xue yuan	80
四川大学华西校区	si chuan da xue hua xi xiao qu	33
四川大学江安校区	si chuan da xue jiang an xiao qu	34
四川大学锦城学院	si chuan da xue jin cheng xue yuan	31
四川大学锦江学院	si chuan da xue jin jiang xue yuan	32
四川大学龙泉校区	si chuan da xue long quan xiao qu	30
四川大学水力发电学院	si chuan da xue shui li fa dian xue yuan	223
四川大学望江校区	si chuan da xue wang jiang xiao qu	35
四川电大教学中心	si chuan dian da jiao xue zhong xin	79
四川电力职业技术学院	si chuan dian li zhi ye ji shu xue yuan	110
四川共青中等职业学校	si chuan gong qing zhong deng zhi ye xue xiao	78
四川管理职业学院	si chuan guan li zhi ye xue yuan	109
四川广播电视大学	si chuan guang bo dian shi da xue	108
四川广播电视中等专业学校	si chuan guang bo dian shi zhong deng zhuan ye xue xiao	76
四川光华学院	si chuan guang hua xue yuan	77
四川国际标榜职业学院	si chuan guo ji biao bang zhi ye xue yuan	107
四川锅炉厂技工学校	si chuan guo lu chang ji gong xue xiao	75
四川航天工业学校	si chuan hang tian gong ye xue xiao	74
四川航天职业技术学院	si chuan hang tian zhi ye ji shu xue yuan	106
四川华新现代职业学院	si chuan hua xin xian dai zhi ye xue yuan	105
四川机电技术学校	si chuan ji dian ji shu xue xiao	73
四川建筑职业技术学院成都校区	si chuan jian zhu zhi ye ji shu xue yuan cheng du xiao qu	72
四川交通学院	si chuan jiao tong xue yuan	71
四川交通职业技术学院	si chuan jiao tong zhi ye ji shu xue yuan	104
四川教育学院	si chuan jiao yu xue yuan	103
四川警安职业学院	si chuan jing an zhi ye xue yuan	101
四川经济管理干部学院	si chuan jing ji guan li gan bu xue yuan	102
四川经济管理学校	si chuan jing ji guan li xue xiao	70
四川科技职工大学	si chuan ke ji zhi gong da xue	100
四川理工大学成都新华科技学院	si chuan li gong da xue cheng du xin hua ke ji xue yuan	69
四川联合经济学校	si chuan lian he jing ji xue xiao	68
四川民盟科技经贸学院	si chuan min meng ke ji jing mao xue yuan	67
四川农大成教部	si chuan nong da cheng jiao bu	66
四川农业管理干部学院	si chuan nong ye guan li gan bu xue yuan	99
四川烹饪高等专科学校	si chuan peng ren gao deng zhuan ke xue xiao	98
四川商务职业学院	si chuan shang wu zhi ye xue yuan	97
四川省成都市北大青鸟培训学院	si chuan sheng cheng du shi bei da qing niao pei xun xue yuan	64
四川省成都市前进职业高级中学	si chuan sheng cheng du shi qian jin zhi ye gao ji zhong xue	181
四川省成都幼儿师范学校	si chuan sheng cheng du you er shi fan xue xiao	128
四川省城市建设学校	si chuan sheng cheng shi jian she xue xiao	63
四川省东方动力职工大学	si chuan sheng dong fang dong li zhi gong da xue	96
四川省公路职业技术学校红牌楼校区	si chuan sheng gong lu zhi ye ji shu xue xiao hong pai lou xiao qu	160
四川省工业设备安装技工学校	si chuan sheng gong ye she bei an zhuang ji gong xue xiao	62
四川省弘博中等专业学校	si chuan sheng hong bo zhong deng zhuan ye xue xiao	61
四川省化工职工大学	si chuan sheng hua gong zhi gong da xue	95
四川省华商学院	si chuan sheng hua shang xue yuan	60
四川省建筑技术进修学院	si chuan sheng jian zhu ji shu jin xiu xue yuan	59
四川省经济技术学校青羊校区	si chuan sheng jing ji ji shu xue xiao qing yang xiao qu	58
四川省经济专修学院	si chuan sheng jing ji zhuan xiu xue yuan	57
四川省农大成都教学部	si chuan sheng nong da cheng du jiao xue bu	56
四川省农业广播电视学院	si chuan sheng nong ye guang bo dian shi xue yuan	55
四川省农业科学院	si chuan sheng nong ye ke xue yuan	54
四川省郫县友爱职业技术学校	si chuan sheng pi xian you ai zhi ye ji shu xue xiao	213
四川省人民医院护士学校	si chuan sheng ren min yi yuan hu shi xue xiao	51
四川省商业服务学校四川省商贸职业培训学院	si chuan sheng shang ye fu wu xue xiao si chuan sheng shang mao zhi ye pei xun xue yuan	234
四川省税务学校	si chuan sheng shui wu xue xiao	53
四川省消防学校	si chuan sheng xiao fang xue xiao	52
四川省饮食服务技工学校成都分校	si chuan sheng yin shi fu wu ji gong xue xiao cheng du fen xiao	50
四川省应用工程学校	si chuan sheng ying yong gong cheng xue xiao	49
四川省运动技术学院	si chuan sheng yun dong ji shu xue yuan	48
四川省职工运动技术学院	si chuan sheng zhi gong yun dong ji shu xue yuan	94
四川生殖卫生学院	si chuan sheng zhi wei sheng xue yuan	65
四川师范大学草堂校区	si chuan shi fan da xue cao tang xiao qu	22
四川师范大学成都实验商贸管理学校	si chuan shi fan da xue cheng du shi yan shang mao guan li xue xiao	193
四川师范大学成龙校区	si chuan shi fan da xue cheng long xiao qu	21
四川师范大学东校区	si chuan shi fan da xue dong xiao qu	23
四川师范大学校本部	si chuan shi fan da xue xiao ben bu	24
四川石油学校	si chuan shi you xue xiao	47
四川体育运动技术学校	si chuan ti yu yun dong ji shu xue xiao	93
四川托普信息技术职业学院	si chuan tuo pu xin xi ji shu zhi ye xue yuan	92
四川外语学院成都学院	si chuan wai yu xue yuan cheng du xue yuan	91
四川外语专修学院	si chuan wai yu zhuan xiu xue yuan	46
四川卫生管理干部学院华西校区	si chuan wei sheng guan li gan bu xue yuan hua xi xiao qu	45
四川文化产业职业学院	si chuan wen hua chan ye zhi ye xue yuan	90
四川信息工程学校	si chuan xin xi gong cheng xue xiao	89
四川行政学院	si chuan xing zheng xue yuan	44
四川艺术职业学院	si chuan yi shu zhi ye xue yuan	127
四川音乐学院	si chuan yin yue xue yuan	2
四川邮电职业技术学院	si chuan you dian zhi ye ji shu xue yuan	88
四川中山学院成都中专部	si chuan zhong shan xue yuan cheng du zhong zhuan bu	126
四川自修大学成都辅导中心	si chuan zi xiu da xue cheng dou fu dao zhong xin	43
托普计算机职业学校	tuo pu ji suan ji zhi ye xue xiao	42
五月花计算机专修学院	wu yue hua ji suan ji zhuan xiu xue yuan	41
西安理工大学成都校区	xi an li gong da xue cheng dou xiao qu	40
西华大学本部	xi hua da xue ben bu	14
西华大学人南校区	xi hua da xue ren nan xiao qu	13
西南财经大学光华校区	xi nan cai jing da xue guang hua xiao qu	15
西南财经大学柳林校区	xi nan cai jing da xue liu lin xiao qu	16
西南交大成教院犀浦校区	xi nan jiao da cheng jiao yuan xi pu xiao qu	215
西南交大欧美科技学院	xi nan jiao da ou mei ke ji xue yuan	216
西南交大网络教育学院	xi nan jiao da wang luo jiao yu xue yuan	39
西南交通大学九里校区老校区	xi nan jiao tong da xue jiu li xiao qu lao xiao qu	26
西南交通大学郫县校区	xi nan jiao tong da xue pi xian xiao qu	27
西南科技大学成都经济技术学校大专部	xi nan ke ji da xue cheng du jing ji ji shu xue xiao da zhuan bu	200
西南科技大学成都经济技术学校中专部	xi nan ke ji da xue cheng du jing ji ji shu xue xiao zhong zhuan bu	201
西南民族大学双流校区	xi nan min zu da xue shuang liu xiao qu	20
西南民族大学太平园校区	xi nan min zu da xue tai ping yuan xiao qu	19
西南民族大学武侯校区	xi nan min zu da xue wu hou xiao qu	18
西南石油大学成都校区	xi nan shi you da xue cheng du xiao qu	1
中国科学院成都分院成教院	zhong guo ke xue yuan cheng du fen yuan cheng jiao yuan	38
中国人民解放军成都医学高等专科学校	zhong guo ren min jie fang jun cheng du yi xue gao deng zhuan ke xue xiao	37
