# 文件名：江苏局部酒店名称.scel
# 词库名：江苏局部酒店名称
# 词库分类：单位机构名
# 词库描述：
# 词条样例：南京中华门饭店 南京御景大酒店 金一村连锁酒店南京夫子庙店 南京金钥匙国际大酒店 南京金色时光假日酒店 南京虹桥饭店
# 词条数量：352

常熟伯泰酒店	chang shu bo tai jiu dian	89
常熟市梅园宾馆	chang shu shi mei yuan bin guan	87
常熟市辛庄镇光华假日酒店	chang shu shi xin zhuang zhen guang hua jia ri jiu dian	86
常熟市钻石年代酒店	chang shu shi zuan shi nian dai jiu dian	88
常熟烟雨大酒店	chang shu yan yu da jiu dian	90
常州宾馆	chang zhou bin guan	237
常州常温宾馆原常州世纪大公馆	chang zhou chang wen bin guan yuan chang zhou shi ji da gong guan	229
常州大成假日酒店	chang zhou da cheng jia ri jiu dian	232
常州鼎盛宾馆	chang zhou ding sheng bin guan	224
常州枫鹭时尚酒店	chang zhou feng lu shi shang jiu dian	240
常州福兰特连锁旅店晋陵店	chang zhou fu lan te lian suo lv dian jin ling dian	226
常州宫苑宾馆	chang zhou gong yuan bin guan	228
常州鸿飞宾馆	chang zhou hong fei bin guan	231
常州嘉华大酒店	chang zhou jia hua da jiu dian	225
常州锦海城市大酒店	chang zhou jin hai cheng shi da jiu dian	238
常州锦海国际大酒店	chang zhou jin hai guo ji da jiu dian	234
常州凯豪大酒店	chang zhou kai hao da jiu dian	230
常州丽景假日酒店	chang zhou li jing jia ri jiu dian	235
常州良茂国际大酒店	chang zhou liang mao guo ji da jiu dian	222
常州苏南枫泽山庄大酒店	chang zhou su nan feng ze shan zhuang da jiu dian	223
常州天宁君和宾馆	chang zhou tian ning jun he bin guan	239
常州吾家吾庭商旅酒店	chang zhou wu jia wu ting shang lv jiu dian	221
常州新锦江商旅酒店	chang zhou xin jin jiang shang lv jiu dian	236
常州园外园宾馆	chang zhou yuan wai yuan bin guan	227
丹阳金色阳光大酒店	dan yang jin se yang guang da jiu dian	27
东台凯悦国际大酒店	dong tai kai yue guo ji da jiu dian	23
东台磊达宾馆	dong tai lei da bin guan	24
丰县星海天大酒店徐州	feng xian xing hai tian da jiu dian xu zhou	1
高邮市水月清华宾馆	gao you shi shui yue qing hua bin guan	18
格林豪泰苏州寒山寺店	ge lin hao tai su zhou han shan si dian	261
格林豪泰苏州木渎天平山店	ge lin hao tai su zhou mu du tian ping shan dian	255
格林豪泰苏州石路店	ge lin hao tai su zhou shi lu dian	294
格林豪泰泰州泰东店	ge lin hao tai tai zhou tai dong dian	96
格林豪泰无锡古运河店	ge lin hao tai wu xi gu yun he dian	195
格林豪泰无锡解放西路店	ge lin hao tai wu xi jie fang xi lu dian	197
格林豪泰无锡锡山友谊店	ge lin hao tai wu xi xi shan you yi dian	196
格林豪泰扬州大厦店	ge lin hao tai yang zhou da sha dian	220
海门永泰国际大酒店	hai men yong tai guo ji da jiu dian	12
汉庭酒店连锁常州常柴店	han ting jiu dian lian suo chang zhou chang chai dian	233
汉庭快捷酒店南通中城店	han ting kuai jie jiu dian nan tong zhong cheng dian	140
汉庭快捷酒店苏州石路二店	han ting kuai jie jiu dian su zhou shi lu er dian	257
汉庭快捷酒店无锡学前街店	han ting kuai jie jiu dian wu xi xue qian jie dian	191
汉庭全季酒店南京汉中门店	han ting quan ji jiu dian nan jing han zhong men dian	346
汉庭全季酒店无锡清名路店	han ting quan ji jiu dian wu xi qing ming lu dian	194
淮安东湖宾馆	huai an dong hu bin guan	64
淮安淮扬府大饭店原淮州宾馆	huai an huai yang fu da fan dian yuan huai zhou bin guan	62
淮安交通宾馆	huai an jiao tong bin guan	60
淮安梅园宾馆	huai an mei yuan bin guan	63
淮安宋王朝大酒店	huai an song wang chao da jiu dian	61
淮安幽兰都大酒店	huai an you lan dou da jiu dian	59
江都大酒店	jiang du da jiu dian	85
江都雄都饭店	jiang du xiong dou fan dian	83
江苏翠屏山宾馆南京	jiang su cui ping shan bin guan nan jing	325
江苏国瑞大酒店南京	jiang su guo rui da jiu dian nan jing	323
江苏江虞宾馆南京	jiang su jiang yu bin guan nan jing	307
江苏物资大厦	jiang su wu zi da sha	348
江苏盐渎花园国际大酒店盐城	jiang su yan du hua yuan guo ji da jiu dian yan cheng	91
姜堰溱湖绿岛假日酒店	jiang yan qin hu lv dao jia ri jiu dian	19
江阴上尚大酒店	jiang yin shang shang da jiu dian	110
江阴市长江饭店	jiang yin shi chang jiang fan dian	108
江阴新扬子大酒店	jiang yin xin yang zi da jiu dian	109
金湖金苏源宾馆淮安	jin hu jin su yuan bin guan huai an	3
锦江之星张家港白玉兰店	jin jiang zhi xing zhang jia gang bai yu lan dian	116
金一村连锁酒店南京夫子庙店	jin yi cun lian suo jiu dian nan jing fu zi miao dian	344
靖江芭堤雅酒店	jing jiang ba di ya jiu dian	21
靖江市水月清华宾馆	jing jiang shi shui yue qing hua bin guan	22
酒店名称	jiu dian ming cheng	352
昆山碧波苑度假村	kun shan bi bo yuan du jia cun	31
昆山并蒂莲大酒店	kun shan bing di lian da jiu dian	43
昆山长江宾馆	kun shan chang jiang bin guan	45
昆山大都会东意假日酒店	kun shan da du hui dong yi jia ri jiu dian	39
昆山大唐宾馆	kun shan da tang bin guan	35
昆山东方丽池商务酒店公寓	kun shan dong fang li chi shang wu jiu dian gong yu	40
昆山和月精致商务酒店	kun shan he yue jing zhi shang wu jiu dian	36
昆山华利大酒店	kun shan hua li da jiu dian	30
昆山金昆宾馆	kun shan jin kun bin guan	41
昆山锦欣大酒店	kun shan jin xin da jiu dian	49
昆山君泰商务酒店	kun shan jun tai shang wu jiu dian	42
昆山凯盛商务酒店	kun shan kai sheng shang wu jiu dian	33
昆山凯悦商务酒店	kun shan kai yue shang wu jiu dian	50
昆山两岸丽景酒店	kun shan liang an li jing jiu dian	29
昆山市丽景百度商务宾馆	kun shan shi li jing bai du shang wu bin guan	47
昆山速安居酒店	kun shan su an ju jiu dian	37
昆山天鹤大酒店	kun shan tian he da jiu dian	34
昆山一醉天元宾馆	kun shan yi zui tian yuan bin guan	32
昆山玉峰大厦	kun shan yu feng da sha	48
昆山誉兴大酒店	kun shan yu xing da jiu dian	44
昆山悦心宾馆	kun shan yue xin bin guan	46
溧水金水湾国际度假村南京	li shui jin shui wan guo ji du jia cun nan jing	2
溧阳翠谷庄园酒店	li yang cui gu zhuang yuan jiu dian	69
溧阳东城宾馆	li yang dong cheng bin guan	66
溧阳环秀山庄	li yang huan xiu shan zhuang	65
溧阳金悦山庄	li yang jin yue shan zhuang	73
溧阳明悦花园酒店	li yang ming yue hua yuan jiu dian	67
溧阳市苏云快捷酒店	li yang shi su yun kuai jie jiu dian	68
溧阳天目湖虹枫度假村	li yang tian mu hu hong feng du jia cun	71
溧阳天目湖水庐宾馆	li yang tian mu hu shui lu bin guan	70
溧阳天目湖水悦山庄	li yang tian mu hu shui yue shan zhuang	74
溧阳望湖岭山庄	li yang wang hu ling shan zhuang	72
连云港东方大酒店	lian yun gang dong fang da jiu dian	132
连云港东海温泉健身会馆	lian yun gang dong hai wen quan jian shen hui guan	15
连云港港龙酒店	lian yun gang gang long jiu dian	125
连云港核电宾馆	lian yun gang he dian bin guan	123
连云港华裕宾馆	lian yun gang hua yu bin guan	120
连云港淮盐大酒店	lian yun gang huai yan da jiu dian	118
连云港嘉悦大酒店原凯悦大酒店	lian yun gang jia yue da jiu dian yuan kai yue da jiu dian	129
连云港杰瑞大厦	lian yun gang jie rui da sha	131
连云港金冠假日宾馆	lian yun gang jin guan jia ri bin guan	119
连云港凯悦花园酒店	lian yun gang kai yue hua yuan jiu dian	134
连云港隆台大酒店	lian yun gang long tai da jiu dian	121
连云港瑞泰酒店	lian yun gang rui tai jiu dian	126
连云港山灵水润大酒店	lian yun gang shan ling shui run da jiu dian	122
连云港世纪港丽国际酒店	lian yun gang shi ji gang li guo ji jiu dian	124
连云港苏豪大酒店	lian yun gang su hao da jiu dian	133
连云港天然居酒店	lian yun gang tian ran ju jiu dian	130
连云港银城国际酒店	lian yun gang yin cheng guo ji jiu dian	117
连云港最佳东方宜家大酒店	lian yun gang zui jia dong fang yi jia da jiu dian	127
连云振兴港桃园宾馆	lian yun zhen xing gang tao yuan bin guan	128
莫泰太仓客运中心店	mo tai tai cang ke yun zhong xin dian	77
莫泰太仓浏河听海路店	mo tai tai cang liu he ting hai lu dian	82
莫泰无锡硕放机场店	mo tai wu xi shuo fang ji chang dian	173
莫泰无锡运河东路店	mo tai wu xi yun he dong lu dian	179
南京巴厘台湾迎湖度假村	nan jing ba li tai wan ying hu du jia cun	302
南京白宫大酒店	nan jing bai gong da jiu dian	337
南京白鹭宾馆	nan jing bai lu bin guan	338
南京白云亭宾馆	nan jing bai yun ting bin guan	308
南京长乐大厦	nan jing chang le da sha	309
南京城市国盟酒店	nan jing cheng shi guo meng jiu dian	296
南京城市休闲酒店	nan jing cheng shi xiu xian jiu dian	330
南京东航之星宾馆	nan jing dong hang zhi xing bin guan	321
南京富建大酒店	nan jing fu jian da jiu dian	303
南京国海大酒店	nan jing guo hai da jiu dian	326
南京昊东宾馆	nan jing hao dong bin guan	324
南京虹桥饭店	nan jing hong qiao fan dian	340
南京华江饭店	nan jing hua jiang fan dian	316
南京嘉逸大酒店	nan jing jia yi da jiu dian	314
南京江南大酒店	nan jing jiang nan da jiu dian	336
南京金榜大酒店	nan jing jin bang da jiu dian	345
南京金长城大酒店	nan jing jin chang cheng da jiu dian	322
南京金陵大厦	nan jing jin ling da sha	335
南京金色时光假日酒店	nan jing jin se shi guang jia ri jiu dian	342
南京金威大酒店培训中心	nan jing jin wei da jiu dian pei xun zhong xin	312
南京锦绣长城大酒店	nan jing jin xiu chang cheng da jiu dian	319
南京金钥匙国际大酒店	nan jing jin yao shi guo ji da jiu dian	343
南京晶丽酒店	nan jing jing li jiu dian	301
南京空港宾馆	nan jing kong gang bin guan	351
南京莱茵达大酒店	nan jing lai yin da da jiu dian	327
南京丽堤汽车旅馆	nan jing li di qi che lv guan	304
南京榴园宾馆	nan jing liu yuan bin guan	329
南京龙华大酒店	nan jing long hua da jiu dian	317
南京龙江宾馆	nan jing long jiang bin guan	310
南京明日大酒店	nan jing ming ri da jiu dian	334
南京南气宾馆	nan jing nan qi bin guan	315
南京年发酒店	nan jing nian fa jiu dian	331
南京瑞华酒店	nan jing rui hua jiu dian	298
南京圣伦大酒店	nan jing sheng lun da jiu dian	306
南京世纪缘大酒店太平门店	nan jing shi ji yuan da jiu dian tai ping men dian	341
南京苏友商务酒店	nan jing su you shang wu jiu dian	299
南京台北沃阁商旅酒店	nan jing tai bei wo ge shang lv jiu dian	300
南京汤泉宾馆	nan jing tang quan bin guan	320
南京汤山一号温泉会所	nan jing tang shan yi hao wen quan hui suo	305
南京天泉宾馆	nan jing tian quan bin guan	332
南京望玉岛度假村高淳县	nan jing wang yu dao du jia cun gao chun xian	313
南京西华门饭店	nan jing xi hua men fan dian	333
南京心之旅花园客栈	nan jing xin zhi lv hua yuan ke zhan	297
南京星湖饭店	nan jing xing hu fan dian	339
南京杏苑宾馆	nan jing xing yuan bin guan	350
南京雍园宾馆	nan jing yong yuan bin guan	311
南京御景大酒店	nan jing yu jing da jiu dian	347
南京悦华大酒店	nan jing yue hua da jiu dian	318
南京珍宝之星商务酒店	nan jing zhen bao zhi xing shang wu jiu dian	328
南京中华门饭店	nan jing zhong hua men fan dian	349
南京中琅假日酒店	nan jing zhong lang jia ri jiu dian	295
南通北辰大酒店	nan tong bei chen da jiu dian	148
南通滨江新景商务酒店	nan tong bin jiang xin jing shang wu jiu dian	149
南通哈雷之星宾馆	nan tong ha lei zhi xing bin guan	142
南通嘉濠宾馆	nan tong jia hao bin guan	152
南通嘉恒假日酒店	nan tong jia heng jia ri jiu dian	143
南通佳利秀水商务酒店	nan tong jia li xiu shui shang wu jiu dian	139
南通锦江花园酒店	nan tong jin jiang hua yuan jiu dian	151
南通金桥大酒店	nan tong jin qiao da jiu dian	153
南通金瑞大酒店	nan tong jin rui da jiu dian	145
南通苹果精品酒店	nan tong ping guo jing pin jiu dian	147
南通商务酒店	nan tong shang wu jiu dian	156
南通万濠大酒店	nan tong wan hao da jiu dian	150
南通文苑商务宾馆	nan tong wen yuan shang wu bin guan	155
南通星海天大酒店	nan tong xing hai tian da jiu dian	146
南通易家商务酒店	nan tong yi jia shang wu jiu dian	141
南通樱花公寓	nan tong ying hua gong yu	154
邳州黄金海岸大酒店	pi zhou huang jin hai an da jiu dian	14
启东兴都大酒店	qi dong xing dou da jiu dian	57
如皋丽泽华庭大酒店	ru gao li ze hua ting da jiu dian	16
如家快捷酒店昆山青阳北路店	ru jia kuai jie jiu dian kun shan qing yang bei lu dian	38
尚客优快捷酒店南通钟秀东路店	shang ke you kuai jie jiu dian nan tong zhong xiu dong lu dian	144
泗阳大酒店	si yang da jiu dian	20
宿迁锦港之星宾馆	su qian jin gang zhi xing bin guan	26
苏州爱尚家精品酒店	su zhou ai shang jia jing pin jiu dian	242
苏州百怡大酒店	su zhou bai yi da jiu dian	243
苏州滨河皇冠商务酒店	su zhou bin he huang guan shang wu jiu dian	281
苏州阊门饭店	su zhou chang men fan dian	285
苏州大都会酒店	su zhou da du hui jiu dian	260
苏州得月阁湖景度假别墅农庄	su zhou de yue ge hu jing du jia bie shu nong zhuang	241
苏州富汇大酒店	su zhou fu hui da jiu dian	277
苏州高新区中豪商务酒店	su zhou gao xin qu zhong hao shang wu jiu dian	272
苏州古吴饭店	su zhou gu wu fan dian	286
苏州观前假日酒店	su zhou guan qian jia ri jiu dian	274
苏州广场酒店	su zhou guang chang jiu dian	245
苏州翰林邻里假日酒店	su zhou han lin lin li jia ri jiu dian	280
苏州涵升假日酒店	su zhou han sheng jia ri jiu dian	246
苏州好家大酒店	su zhou hao jia da jiu dian	248
苏州虎丘山庄	su zhou hu qiu shan zhuang	263
苏州华侨饭店	su zhou hua qiao fan dian	279
苏州环龙商务酒店	su zhou huan long shang wu jiu dian	265
苏州金桥假日大酒店	su zhou jin qiao jia ri da jiu dian	275
苏州金区新嘉福汽车旅馆	su zhou jin qu xin jia fu qi che lv guan	268
苏州景旺酒店	su zhou jing wang jiu dian	293
苏州久怡假日酒店	su zhou jiu yi jia ri jiu dian	258
苏州九州商务宾馆	su zhou jiu zhou shang wu bin guan	288
苏州凯华世家酒店景德路店	su zhou kai hua shi jia jiu dian jing de lu dian	256
苏州乐活青年旅舍	su zhou le huo qing nian lv she	250
苏州乐园度假酒店	su zhou le yuan du jia jiu dian	264
苏州乐园度假酒店园区东环路店	su zhou le yuan du jia jiu dian yuan qu dong huan lu dian	249
苏州丽晶水庄大酒店	su zhou li jing shui zhuang da jiu dian	273
苏州玲珑邻里假日酒店	su zhou ling long lin li jia ri jiu dian	270
苏州旅游饭店	su zhou lv you fan dian	259
苏州米兰华庭宾馆	su zhou mi lan hua ting bin guan	289
苏州名城万丽商务酒店	su zhou ming cheng wan li shang wu jiu dian	269
苏州木渎永利假日酒店	su zhou mu du yong li jia ri jiu dian	244
苏州平江区新豪盛宾馆	su zhou ping jiang qu xin hao sheng bin guan	276
苏州乾康大酒店	su zhou qian kang da jiu dian	267
苏州清澄绿洲商务会馆	su zhou qing cheng lv zhou shang wu hui guan	266
苏州胜家宾馆	su zhou sheng jia bin guan	287
苏州水云天酒店	su zhou shui yun tian jiu dian	247
苏州太湖香榭丽花园会所	su zhou tai hu xiang xie li hua yuan hui suo	284
苏州吴地人家大酒店	su zhou wu di ren jia da jiu dian	262
苏州新东吴珍珠大酒店	su zhou xin dong wu zhen zhu da jiu dian	282
苏州新天伦之乐大酒店	su zhou xin tian lun zhi le da jiu dian	271
苏州新文宾馆	su zhou xin wen bin guan	278
苏州宜必思酒店	su zhou yi bi si jiu dian	251
苏州伊林德大酒店	su zhou yi lin de da jiu dian	283
苏州银泉山庄大酒店	su zhou yin quan shan zhuang da jiu dian	292
苏州友谊宾馆	su zhou you yi bin guan	291
苏州御海湾商务酒店	su zhou yu hai wan shang wu jiu dian	254
苏州园区九九商务宾馆	su zhou yuan qu jiu jiu shang wu bin guan	290
苏州浙商商务酒店	su zhou zhe shang shang wu jiu dian	252
苏州左邻右里假日宾馆	su zhou zuo lin you li jia ri bin guan	253
太仓昌和酒店	tai cang chang he jiu dian	76
太仓春天宾馆	tai cang chun tian bin guan	80
太仓东航商务鎏渊大酒店	tai cang dong hang shang wu liu yuan da jiu dian	79
太仓苏豪宾馆	tai cang su hao bin guan	78
太仓太阳城酒店	tai cang tai yang cheng jiu dian	81
泰兴上城商务酒店	tai xing shang cheng shang wu jiu dian	58
泰州国泰大酒店	tai zhou guo tai da jiu dian	101
泰州会宾楼宾馆	tai zhou hui bin lou bin guan	95
泰州会宾楼永泰大酒店	tai zhou hui bin lou yong tai da jiu dian	100
泰州金色大地商务会所	tai zhou jin se da di shang wu hui suo	97
泰州开泰宾馆	tai zhou kai tai bin guan	99
泰州绿晶国际大酒店	tai zhou lv jing guo ji da jiu dian	94
泰州沃特龙大酒店	tai zhou wo te long da jiu dian	98
同里敬仪堂客栈	tong li jing yi tang ke zhan	75
通州联邦大酒店	tong zhou lian bang da jiu dian	10
通州桃花源假日酒店	tong zhou tao hua yuan jia ri jiu dian	11
吴江富都假日酒店	wu jiang fu dou jia ri jiu dian	106
吴江海德皇宫大酒店	wu jiang hai de huang gong da jiu dian	105
吴江虹胜宾馆	wu jiang hong sheng bin guan	107
吴江金百合快捷酒店	wu jiang jin bai he kuai jie jiu dian	102
吴江吴都大酒店	wu jiang wu du da jiu dian	104
吴江新东升宾馆	wu jiang xin dong sheng bin guan	103
无锡安德福金色海岸酒店	wu xi an de fu jin se hai an jiu dian	168
无锡百喜大酒店	wu xi bai xi da jiu dian	181
无锡宝隆商务酒店	wu xi bao long shang wu jiu dian	184
无锡波尔麦时尚酒店	wu xi bo er mai shi shang jiu dian	193
无锡铂金商务酒店	wu xi bo jin shang wu jiu dian	192
无锡长城大酒店	wu xi chang cheng da jiu dian	172
无锡古罗马大酒店	wu xi gu luo ma da jiu dian	188
无锡汉友大酒店	wu xi han you da jiu dian	176
无锡金色豪门酒店	wu xi jin se hao men jiu dian	185
无锡聚丰园大酒店	wu xi ju feng yuan da jiu dian	189
无锡凯丽大酒店	wu xi kai li da jiu dian	169
无锡美嘉美时尚短租酒店公寓	wu xi mei jia mei shi shang duan zu jiu dian gong yu	177
无锡市吉泰名人商务酒店	wu xi shi ji tai ming ren shang wu jiu dian	171
无锡时尚城市商务酒店	wu xi shi shang cheng shi shang wu jiu dian	187
无锡泰山饭店	wu xi tai shan fan dian	183
无锡天长地久商务酒店	wu xi tian chang di jiu shang wu jiu dian	175
无锡天骄宾馆	wu xi tian jiao bin guan	178
无锡维多利亚商务酒店	wu xi wei duo li ya shang wu jiu dian	170
无锡唯嘉商务酒店	wu xi wei jia shang wu jiu dian	174
无锡物产大酒店	wu xi wu chan da jiu dian	190
无锡五三零人才商务酒店	wu xi wu san ling ren cai shang wu jiu dian	180
无锡新横山饭店	wu xi xin heng shan fan dian	182
无锡亿鹭发海鲜大酒店	wu xi yi lu fa hai xian da jiu dian	186
新沂亚欧大酒店	xin yi ya ou da jiu dian	25
兴化市喜来居大酒店	xing hua shi xi lai ju da jiu dian	9
兴化天港假日酒店	xing hua tian gang jia ri jiu dian	8
盱眙宾馆	xu yi bin guan	5
盱眙两可间铁山寺森林度假村	xu yi liang ke jian tie shan si sen lin du jia cun	4
盱眙盈通天泉度假山庄	xu yi ying tong tian quan du jia shan zhuang	6
徐州白云大酒店	xu zhou bai yun da jiu dian	165
徐州财富商务酒店	xu zhou cai fu shang wu jiu dian	161
徐州饭店	xu zhou fan dian	167
徐州国源宾馆铜山	xu zhou guo yuan bin guan tong shan	7
徐州花园饭店	xu zhou hua yuan fan dian	166
徐州黄河饭店原徐州市工会宾馆	xu zhou huang he fan dian yuan xu zhou shi gong hui bin guan	163
徐州金港大酒店	xu zhou jin gang da jiu dian	157
徐州今驿之家酒店	xu zhou jin yi zhi jia jiu dian	159
徐州陶然居精品商务酒店	xu zhou tao ran ju jing pin shang wu jiu dian	160
徐州望园酒店	xu zhou wang yuan jiu dian	158
徐州中豪大酒店	xu zhou zhong hao da jiu dian	164
徐州中山饭店	xu zhou zhong shan fan dian	162
盐城建军饭店	yan cheng jian jun fan dian	92
盐城温泉宾馆	yan cheng wen quan bin guan	93
盐城银都大酒店大丰	yan cheng yin du da jiu dian da feng	13
扬中金叶大酒店	yang zhong jin ye da jiu dian	111
扬州宾馆	yang zhou bin guan	215
扬州萃园城市酒店	yang zhou cui yuan cheng shi jiu dian	207
扬州二十四桥宾馆	yang zhou er shi si qiao bin guan	200
扬州广源丁山大酒店	yang zhou guang yuan ding shan da jiu dian	216
扬州红杉树酒店	yang zhou hong shan shu jiu dian	213
扬州鸿翔假日酒店	yang zhou hong xiang jia ri jiu dian	211
扬州锦城假日酒店	yang zhou jin cheng jia ri jiu dian	203
扬州锦润国际大酒店江都	yang zhou jin run guo ji da jiu dian jiang du	84
扬州开元江隆酒店	yang zhou kai yuan jiang long jiu dian	214
扬州蓝生宾馆高邮	yang zhou lan sheng bin guan gao you	17
扬州琼都宾馆	yang zhou qiong dou bin guan	219
扬州润扬大酒店	yang zhou run yang da jiu dian	209
扬州神州商旅宾馆	yang zhou shen zhou shang lv bin guan	217
扬州市福友宾馆	yang zhou shi fu you bin guan	201
扬州石塔宾馆	yang zhou shi ta bin guan	212
扬州蜀岗西峰大酒店	yang zhou shu gang xi feng da jiu dian	198
扬州天虹大酒店	yang zhou tian hong da jiu dian	208
扬州天香阁酒店	yang zhou tian xiang ge jiu dian	205
扬州铁道宾馆	yang zhou tie dao bin guan	206
扬州万顺大酒店	yang zhou wan shun da jiu dian	218
扬州雅阁商务酒店	yang zhou ya ge shang wu jiu dian	210
扬州怡园饭店	yang zhou yi yuan fan dian	202
扬州远锦国际大酒店	yang zhou yuan jin guo ji da jiu dian	199
扬州云锦假日酒店	yang zhou yun jin jia ri jiu dian	204
宜兴华亭国际酒店	yi xing hua ting guo ji jiu dian	136
宜兴陶都大饭店	yi xing tao du da fan dian	135
优家连锁昆山雍景湾酒店公寓	you jia lian suo kun shan yong jing wan jiu dian gong yu	28
张家港大新新滨江假日酒店	zhang jia gang da xin xin bin jiang jia ri jiu dian	112
张家港景海宾馆	zhang jia gang jing hai bin guan	114
张家港新京华商务宾馆	zhang jia gang xin jing hua shang wu bin guan	113
张家港新世汇时尚精品酒店	zhang jia gang xin shi hui shi shang jing pin jiu dian	115
镇江京口东瀚宾馆	zhen jiang jing kou dong han bin guan	137
镇江一泉宾馆	zhen jiang yi quan bin guan	138
周庄富贵园度假会所	zhou zhuang fu gui yuan du jia hui suo	54
周庄笑笛轩宾馆客栈	zhou zhuang xiao di xuan bin guan ke zhan	53
周庄银子浜客栈	zhou zhuang yin zi bang ke zhan	56
周庄云海度假村	zhou zhuang yun hai du jia cun	55
周庄贞固堂客栈	zhou zhuang zhen gu tang ke zhan	52
周庄正福草堂客栈	zhou zhuang zheng fu cao tang ke zhan	51
