# 文件名：济源企业名称.scel
# 词库名：济源企业名称
# 词库分类：单位机构名
# 词库描述：
# 词条样例：济源市环境监察支队 运行监察科 河南济源钢铁集团有限公司 中原特钢股份有限公司 河南金马能源有限公司 河南联创化工有限公司
# 词条数量：71

北京航天益来电子技术有限公司	bei jing hang tian yi lai dian zi ji shu you xian gong si	66
北京嘉禾木科技有限公司	bei jing jia he mu ke ji you xian gong si	16
博海化工有限公司	bo hai hua gong you xian gong si	38
方升化学有限公司	fang sheng hua xue you xian gong si	24
富士康济源科技园	fu shi kang ji yuan ke ji yuan	46
国电豫源发电有限责任公司	guo dian yu yuan fa dian you xian ze ren gong si	60
海容化工	hai rong hua gong	8
河南博海化工有限公司	he nan bo hai hua gong you xian gong si	45
河南恒通化工有限公司	he nan heng tong hua gong you xian gong si	19
河南济源钢铁集团有限公司	he nan ji yuan gang tie ji tuan you xian gong si	65
河南金利金铅有限公司	he nan jin li jin qian you xian gong si	61
河南金马能源有限公司	he nan jin ma neng yuan you xian gong si	55
河南联创化工有限公司	he nan lian chuang hua gong you xian gong si	53
河南联创化工有限责任公司	he nan lian chuang hua gong you xian ze ren gong si	20
河南盛荣特种钢业有限公司	he nan sheng rong te zhong gang ye you xian gong si	10
河南豫港焦化有限公司	he nan yu gang jiao hua you xian gong si	34
河南豫光金铅股份有限公司	he nan yu guang jin qian gu fen you xian gong si	59
河南豫光金铅集团有限公司	he nan yu guang jin qian ji tuan you xian gong si	33
河南豫光金铅集团有限责任公司	he nan yu guang jin qian ji tuan you xian ze ren gong si	40
河南豫光锌业有限公司	he nan yu guang xin ye you xian gong si	58
河南中沃实业有限公司	he nan zhong wo shi ye you xian gong si	48
河南中沃饮料有限公司	he nan zhong wo yin liao you xian gong si	14
恒通威龙	heng tong wei long	7
华能沁北发电有限公司	hua neng qin bei fa dian you xian gong si	18
华能沁北发电有限责任公司	hua neng qin bei fa dian you xian ze ren gong si	54
济源金龙水泥有限公司	ji yuan jin long shui ni you xian gong si	11
济源煤业有限公司	ji yuan mei ye you xian gong si	30
济源市奔月浮法玻璃有限公司	ji yuan shi ben yue fu fa bo li you xian gong si	27
济源市城市污水处理厂	ji yuan shi cheng shi wu shui chu li chang	50
济源市方升化学有限公司	ji yuan shi fang sheng hua xue you xian gong si	52
济源市丰田肥业有限公司	ji yuan shi feng tian fei ye you xian gong si	32
济源市公美集团有限公司	ji yuan shi gong mei ji tuan you xian gong si	17
济源市恒利肥业有限公司	ji yuan shi heng li fei ye you xian gong si	31
济源市环境保护局	ji yuan shi huan jing bao hu ju	71
济源市环境监察支队	ji yuan shi huan jing jian cha zhi dui	70
济源市环境自动监控中心	ji yuan shi huan jing zi dong jian kong zhong xin	69
济源市金利冶炼有限责任公司	ji yuan shi jin li ye lian you xian ze ren gong si	37
济源市金马焦化有限公司	ji yuan shi jin ma jiao hua you xian gong si	36
济源市巨康陶瓷有限公司	ji yuan shi ju kang tao ci you xian gong si	26
济源市绿源实业有限公司	ji yuan shi lv yuan shi ye you xian gong si	13
济源市耐火炉业有限公司	ji yuan shi nai huo lu ye you xian gong si	28
济源市盘古水磨水泥厂	ji yuan shi pan gu shui mo shui ni chang	12
济源市双汇食品有限公司	ji yuan shi shuang hui shi pin you xian gong si	51
济源市太行建材有限公司	ji yuan shi tai hang jian cai you xian gong si	29
济源市太行水泥有限公司	ji yuan shi tai hang shui ni you xian gong si	57
济源市腾盛纸业有限公司	ji yuan shi teng sheng zhi ye you xian gong si	44
济源市天龙焦化有限公司	ji yuan shi tian long jiao hua you xian gong si	47
济源市天坛山水泥有限公司	ji yuan shi tian tan shan shui ni you xian gong si	22
济源市万洋冶炼集团有限公司	ji yuan shi wan yang ye lian ji tuan you xian gong si	63
济源市五龙纸业有限公司	ji yuan shi wu long zhi ye you xian gong si	15
济源市欣欣实业有限公司	ji yuan shi xin xin shi ye you xian gong si	43
济源市裕鑫铜业有限公司	ji yuan shi yu xin tong ye you xian gong si	42
济源市战成水泥有限公司	ji yuan shi zhan cheng shui ni you xian gong si	21
济源五三一水泥厂	ji yuan wu san yi shui ni chang	23
济源伊利乳业有限责任公司	ji yuan yi li ru ye you xian ze ren gong si	41
济源中博新能源集团有限公司	ji yuan zhong bo xin neng yuan ji tuan you xian gong si	49
金马焦化有限公司	jin ma jiao hua you xian gong si	39
金宁公司	jin ning gong si	35
排污收费科	pai wu shou fei ke	67
麒麟铜锌	qi lin tong xin	3
天龙焦化	tian long jiao hua	9
万洋肥业	wan yang fei ye	2
万洋绿色能源	wan yang lv se neng yuan	62
污水处理厂	wu shui chu li chang	25
豫港济源焦化集团有限公司	yu gang ji yuan jiao hua ji tuan you xian gong si	64
宇鑫丝绸	yu xin si chou	6
豫源化电	yu yuan hua dian	5
运行监察科	yun xing jian cha ke	68
正兴玉米	zheng xing yu mi	4
中联水泥	zhong lian shui ni	1
中原特钢股份有限公司	zhong yuan te gang gu fen you xian gong si	56
