# 文件名：海拉尔.scel
# 词库名：海拉尔
# 词库分类：行政区划地名
# 词库描述：
# 词条样例：哈克村 联合村 团结村 建设镇 工人新村 扎兰屯路
# 词条数量：55

宝矿	bao kuang	2
贝尔路	bei er lu	39
车站附近	che zhan fu jin	5
奋斗镇	fen dou zhen	35
富强村	fu qiang cun	34
工人新村	gong ren xin cun	42
光明村	guang ming cun	47
哈克村	ha ke cun	54
哈克镇	ha ke zhen	55
河东	he dong	41
和平村	he ping cun	33
河西	he xi	40
合作村	he zuo cun	45
互助村	hu zhu cun	46
健康办	jian kang ban	43
健康办事处	jian kang ban shi chu	44
建设镇	jian she zhen	48
矿区	kuang qu	1
联合村	lian he cun	53
联合一村	lian he yi cun	51
玫瑰园	mei gui yuan	8
木兰街	mu lan jie	7
仁德里街	ren de li jie	6
三角地	san jiao di	37
胜利村	sheng li cun	30
十六号村	shi liu hao cun	49
铁路	tie lu	29
铁路道北牡丹小区	tie lu dao bei mu dan xiao qu	4
铁路工人新村八道街	tie lu gong ren xin cun ba dao jie	21
铁路工人新村二道街	tie lu gong ren xin cun er dao jie	27
铁路工人新村二十道街	tie lu gong ren xin cun er shi dao jie	9
铁路工人新村九道街	tie lu gong ren xin cun jiu dao jie	20
铁路工人新村六道街	tie lu gong ren xin cun liu dao jie	23
铁路工人新村七道街	tie lu gong ren xin cun qi dao jie	22
铁路工人新村三道街	tie lu gong ren xin cun san dao jie	26
铁路工人新村十八道街	tie lu gong ren xin cun shi ba dao jie	11
铁路工人新村十道街	tie lu gong ren xin cun shi dao jie	19
铁路工人新村十二道街	tie lu gong ren xin cun shi er dao jie	17
铁路工人新村十九道街	tie lu gong ren xin cun shi jiu dao jie	10
铁路工人新村十六道街	tie lu gong ren xin cun shi liu dao jie	13
铁路工人新村十七道街	tie lu gong ren xin cun shi qi dao jie	12
铁路工人新村十三道街	tie lu gong ren xin cun shi san dao jie	16
铁路工人新村十四道街	tie lu gong ren xin cun shi si dao jie	15
铁路工人新村十五道街	tie lu gong ren xin cun shi wu dao jie	14
铁路工人新村十一道街	tie lu gong ren xin cun shi yi dao jie	18
铁路工人新村四道街	tie lu gong ren xin cun si dao jie	25
铁路工人新村五道街	tie lu gong ren xin cun wu dao jie	24
铁路工人新村一道街	tie lu gong ren xin cun yi dao jie	28
团结村	tuan jie cun	52
向华办事处	xiang hua ban shi chu	36
新区	xin qu	3
友好村	you hao cun	32
友联村	you lian cun	31
扎兰屯路	zha lan tun lu	38
扎罗木得村	zha luo mu de cun	50
