# 文件名：涞源县学校单位名称.scel
# 词库名：涞源县学校单位名称
# 词库分类：单位机构名
# 词库描述：
# 词条样例：涞源县烟煤洞乡曹家沟小学 涞源县东团堡乡中学 涞源县南屯乡小炉沟小学 涞源县北石佛中学 涞源县王安镇中学
# 词条数量：203

河北省涞源县北城子中学	he bei sheng lai yuan xian bei cheng zi zhong xue	196
河北省涞源县第二中学	he bei sheng lai yuan xian di er zhong xue	194
河北省涞源县第三中学	he bei sheng lai yuan xian di san zhong xue	198
涞源县白石山镇白石口小学	lai yuan xian bai shi shan zhen bai shi kou xiao xue	13
涞源县白石山镇白石山小学	lai yuan xian bai shi shan zhen bai shi shan xiao xue	27
涞源县白石山镇插箭岭小学	lai yuan xian bai shi shan zhen cha jian ling xiao xue	16
涞源县白石山镇大草滩小学	lai yuan xian bai shi shan zhen da cao tan xiao xue	9
涞源县白石山镇东龙虎小学	lai yuan xian bai shi shan zhen dong long hu xiao xue	101
涞源县白石山镇斗军湾小学	lai yuan xian bai shi shan zhen dou jun wan xiao xue	11
涞源县白石山镇丰粮小学	lai yuan xian bai shi shan zhen feng liang xiao xue	21
涞源县白石山镇金山口小学	lai yuan xian bai shi shan zhen jin shan kou xiao xue	14
涞源县白石山镇灵吉小学	lai yuan xian bai shi shan zhen ling ji xiao xue	10
涞源县白石山镇石窝小学	lai yuan xian bai shi shan zhen shi wo xiao xue	24
涞源县白石山镇西龙虎小学	lai yuan xian bai shi shan zhen xi long hu xiao xue	25
涞源县白石山镇西庄铺小学	lai yuan xian bai shi shan zhen xi zhuang pu xiao xue	12
涞源县白石山镇香沟小学	lai yuan xian bai shi shan zhen xiang gou xiao xue	8
涞源县白石山镇杨家川小学	lai yuan xian bai shi shan zhen yang jia chuan xiao xue	26
涞源县白石山镇寨子小学	lai yuan xian bai shi shan zhen zhai zi xiao xue	22
涞源县白石山镇庄伙小学	lai yuan xian bai shi shan zhen zhuang huo xiao xue	23
涞源县北石佛乡艾河小学	lai yuan xian bei shi fo xiang ai he xiao xue	18
涞源县北石佛乡白绸小学	lai yuan xian bei shi fo xiang bai chou xiao xue	200
涞源县北石佛乡北上屯小学	lai yuan xian bei shi fo xiang bei shang tun xiao xue	6
涞源县北石佛乡红泉小学	lai yuan xian bei shi fo xiang hong quan xiao xue	17
涞源县北石佛乡冀家会小学	lai yuan xian bei shi fo xiang ji jia hui xiao xue	2
涞源县北石佛乡刘家咀小学	lai yuan xian bei shi fo xiang liu jia ju xiao xue	15
涞源县北石佛乡南上屯小学	lai yuan xian bei shi fo xiang nan shang tun xiao xue	19
涞源县北石佛乡牌坊小学	lai yuan xian bei shi fo xiang pai fang xiao xue	3
涞源县北石佛乡石道沟小学	lai yuan xian bei shi fo xiang shi dao gou xiao xue	5
涞源县北石佛乡西道沟小学	lai yuan xian bei shi fo xiang xi dao gou xiao xue	182
涞源县北石佛乡张家峪小学	lai yuan xian bei shi fo xiang zhang jia yu xiao xue	4
涞源县北石佛乡中心小学	lai yuan xian bei shi fo xiang zhong xin xiao xue	20
涞源县北石佛中学	lai yuan xian bei shi fo zhong xue	192
涞源县第二小学	lai yuan xian di er xiao xue	175
涞源县第一小学	lai yuan xian di yi xiao xue	113
涞源县第一中学	lai yuan xian di yi zhong xue	201
涞源县东团堡乡北李庄小学	lai yuan xian dong tuan bao xiang bei li zhuang xiao xue	65
涞源县东团堡乡北梁家庄小学	lai yuan xian dong tuan bao xiang bei liang jia zhuang xiao xue	177
涞源县东团堡乡北辛庄小学	lai yuan xian dong tuan bao xiang bei xin zhuang xiao xue	40
涞源县东团堡乡大道沟小学	lai yuan xian dong tuan bao xiang da dao gou xiao xue	64
涞源县东团堡乡杄树底小学	lai yuan xian dong tuan bao xiang qian shu di xiao xue	102
涞源县东团堡乡汤子岭小学	lai yuan xian dong tuan bao xiang tang zi ling xiao xue	54
涞源县东团堡乡王家湾小学	lai yuan xian dong tuan bao xiang wang jia wan xiao xue	67
涞源县东团堡乡五节崖小学	lai yuan xian dong tuan bao xiang wu jie ya xiao xue	44
涞源县东团堡乡西团堡小学	lai yuan xian dong tuan bao xiang xi tuan bao xiao xue	45
涞源县东团堡乡卸甲沟小学	lai yuan xian dong tuan bao xiang xie jia gou xiao xue	43
涞源县东团堡乡养老河小学	lai yuan xian dong tuan bao xiang yang lao he xiao xue	66
涞源县东团堡乡杨庄小学	lai yuan xian dong tuan bao xiang yang zhuang xiao xue	41
涞源县东团堡乡袁家村小学	lai yuan xian dong tuan bao xiang yuan jia cun xiao xue	42
涞源县东团堡乡中心小学	lai yuan xian dong tuan bao xiang zhong xin xiao xue	190
涞源县东团堡乡中学	lai yuan xian dong tuan bao xiang zhong xue	193
涞源县教师发展中心	lai yuan xian jiao shi fa zhan zhong xin	202
涞源县金家井乡南坡底小学	lai yuan xian jin jia jing xiang nan po di xiao xue	170
涞源县金家井乡王家井小学	lai yuan xian jin jia jing xiang wang jia jing xiao xue	168
涞源县金家井乡斜山小学	lai yuan xian jin jia jing xiang xie shan xiao xue	171
涞源县金家井乡张家庄小学	lai yuan xian jin jia jing xiang zhang jia zhuang xiao xue	174
涞源县金家井乡中心小学	lai yuan xian jin jia jing xiang zhong xin xiao xue	173
涞源县金家井乡周村小学	lai yuan xian jin jia jing xiang zhou cun xiao xue	172
涞源县晶华学校	lai yuan xian jing hua xue xiao	197
涞源县涞源小学	lai yuan xian lai yuan xiao xue	29
涞源县涞源镇北台小学	lai yuan xian lai yuan zhen bei tai xiao xue	38
涞源县涞源镇北屯小学	lai yuan xian lai yuan zhen bei tun xiao xue	28
涞源县涞源镇东夹山小学	lai yuan xian lai yuan zhen dong jia shan xiao xue	98
涞源县涞源镇东神山小学	lai yuan xian lai yuan zhen dong shen shan xiao xue	189
涞源县涞源镇二道河小学	lai yuan xian lai yuan zhen er dao he xiao xue	39
涞源县涞源镇冯村小学	lai yuan xian lai yuan zhen feng cun xiao xue	183
涞源县涞源镇丰乐小学	lai yuan xian lai yuan zhen feng le xiao xue	30
涞源县涞源镇甲村中心小学	lai yuan xian lai yuan zhen jia cun zhong xin xiao xue	179
涞源县涞源镇曲村小学	lai yuan xian lai yuan zhen qu cun xiao xue	99
涞源县涞源镇三甲村中心小学	lai yuan xian lai yuan zhen san jia cun zhong xin xiao xue	31
涞源县涞源镇王家湾小学	lai yuan xian lai yuan zhen wang jia wan xiao xue	100
涞源县涞源镇西夹山小学	lai yuan xian lai yuan zhen xi jia shan xiao xue	97
涞源县涞源镇西神山小学	lai yuan xian lai yuan zhen xi shen shan xiao xue	156
涞源县涞源镇香炉屯小学	lai yuan xian lai yuan zhen xiang lu tun xiao xue	103
涞源县涞源镇小西庄小学	lai yuan xian lai yuan zhen xiao xi zhuang xiao xue	96
涞源县涞源镇新街小学	lai yuan xian lai yuan zhen xin jie xiao xue	157
涞源县涞源镇沿村小学	lai yuan xian lai yuan zhen yan cun xiao xue	150
涞源县联合关中心小学	lai yuan xian lian he guan zhong xin xiao xue	176
涞源县留家庄乡烧车小学	lai yuan xian liu jia zhuang xiang shao che xiao xue	68
涞源县留家庄乡水石塘小学	lai yuan xian liu jia zhuang xiang shui shi tang xiao xue	69
涞源县留家庄乡游家熙希望小学	lai yuan xian liu jia zhuang xiang you jia xi xi wang xiao xue	70
涞源县留家庄乡张家铺小学	lai yuan xian liu jia zhuang xiang zhang jia pu xiao xue	71
涞源县留家庄乡中心小学	lai yuan xian liu jia zhuang xiang zhong xin xiao xue	72
涞源县明德小学	lai yuan xian ming de xiao xue	158
涞源县南关中心小学	lai yuan xian nan guan zhong xin xiao xue	181
涞源县南马庄乡范台小学	lai yuan xian nan ma zhuang xiang fan tai xiao xue	56
涞源县南马庄乡范庄旺小学	lai yuan xian nan ma zhuang xiang fan zhuang wang xiao xue	60
涞源县南马庄乡古道小学	lai yuan xian nan ma zhuang xiang gu dao xiao xue	61
涞源县南马庄乡狼牙口小学	lai yuan xian nan ma zhuang xiang lang ya kou xiao xue	59
涞源县南马庄乡望天岭小学	lai yuan xian nan ma zhuang xiang wang tian ling xiao xue	55
涞源县南马庄乡向阳会小学	lai yuan xian nan ma zhuang xiang xiang yang hui xiao xue	62
涞源县南马庄乡小关城小学	lai yuan xian nan ma zhuang xiang xiao guan cheng xiao xue	58
涞源县南马庄乡谢台小学	lai yuan xian nan ma zhuang xiang xie tai xiao xue	57
涞源县南马庄乡中心小学	lai yuan xian nan ma zhuang xiang zhong xin xiao xue	63
涞源县南屯乡大炉沟小学	lai yuan xian nan tun xiang da lu gou xiao xue	161
涞源县南屯乡杜村小学	lai yuan xian nan tun xiang du cun xiao xue	140
涞源县南屯乡胡家庄小学	lai yuan xian nan tun xiang hu jia zhuang xiao xue	160
涞源县南屯乡金家庄小学	lai yuan xian nan tun xiang jin jia zhuang xiao xue	151
涞源县南屯乡马圈小学	lai yuan xian nan tun xiang ma juan xiao xue	138
涞源县南屯乡小炉沟小学	lai yuan xian nan tun xiang xiao lu gou xiao xue	187
涞源县南屯乡张家庄小学	lai yuan xian nan tun xiang zhang jia zhuang xiao xue	139
涞源县南屯乡中心小学	lai yuan xian nan tun xiang zhong xin xiao xue	146
涞源县上庄乡峨头小学	lai yuan xian shang zhuang xiang e tou xiao xue	167
涞源县上庄乡黄郊小学	lai yuan xian shang zhuang xiang huang jiao xiao xue	123
涞源县上庄乡南阳峪小学	lai yuan xian shang zhuang xiang nan yang yu xiao xue	7
涞源县上庄乡狮子峪小学	lai yuan xian shang zhuang xiang shi zi yu xiao xue	135
涞源县上庄乡西泉头小学	lai yuan xian shang zhuang xiang xi quan tou xiao xue	136
涞源县上庄乡下老芳小学	lai yuan xian shang zhuang xiang xia lao fang xiao xue	134
涞源县上庄乡中心小学	lai yuan xian shang zhuang xiang zhong xin xiao xue	112
涞源县上庄乡中庄小学	lai yuan xian shang zhuang xiang zhong zhuang xiao xue	137
涞源县上庄中学	lai yuan xian shang zhuang zhong xue	199
涞源县实验小学	lai yuan xian shi yan xiao xue	89
涞源县水堡镇井子会小学	lai yuan xian shui bao zhen jing zi hui xiao xue	80
涞源县水堡镇柳沟小学	lai yuan xian shui bao zhen liu gou xiao xue	78
涞源县水堡镇龙家庄小学	lai yuan xian shui bao zhen long jia zhuang xiao xue	79
涞源县水堡镇龙门小学	lai yuan xian shui bao zhen long men xiao xue	76
涞源县水堡镇三合庄小学	lai yuan xian shui bao zhen san he zhuang xiao xue	75
涞源县水堡镇石塘沟小学	lai yuan xian shui bao zhen shi tang gou xiao xue	74
涞源县水堡镇水堡小学	lai yuan xian shui bao zhen shui bao xiao xue	77
涞源县水堡镇中心小学	lai yuan xian shui bao zhen zhong xin xiao xue	81
涞源县塔崖驿乡板铺庄小学	lai yuan xian ta ya yi xiang ban pu zhuang xiao xue	128
涞源县塔崖驿乡大东沟小学	lai yuan xian ta ya yi xiang da dong gou xiao xue	127
涞源县塔崖驿乡东杏花小学	lai yuan xian ta ya yi xiang dong xing hua xiao xue	149
涞源县塔崖驿乡二道河小学	lai yuan xian ta ya yi xiang er dao he xiao xue	147
涞源县塔崖驿乡黄岩头小学	lai yuan xian ta ya yi xiang huang yan tou xiao xue	129
涞源县塔崖驿中心小学	lai yuan xian ta ya yi zhong xin xiao xue	148
涞源县王安镇鲍家路小学	lai yuan xian wang an zhen bao jia lu xiao xue	145
涞源县王安镇东辛庄小学	lai yuan xian wang an zhen dong xin zhuang xiao xue	188
涞源县王安镇杜家台小学	lai yuan xian wang an zhen du jia tai xiao xue	141
涞源县王安镇黄台院小学	lai yuan xian wang an zhen huang tai yuan xiao xue	143
涞源县王安镇冷铺小学	lai yuan xian wang an zhen leng pu xiao xue	155
涞源县王安镇刘家庄小学	lai yuan xian wang an zhen liu jia zhuang xiao xue	180
涞源县王安镇芦草湾小学	lai yuan xian wang an zhen lu cao wan xiao xue	162
涞源县王安镇祁家沟小学	lai yuan xian wang an zhen qi jia gou xiao xue	163
涞源县王安镇山炮小学	lai yuan xian wang an zhen shan pao xiao xue	1
涞源县王安镇上花台小学	lai yuan xian wang an zhen shang hua tai xiao xue	153
涞源县王安镇孙家泉小学	lai yuan xian wang an zhen sun jia quan xiao xue	164
涞源县王安镇王家庄小学	lai yuan xian wang an zhen wang jia zhuang xiao xue	165
涞源县王安镇小岭根小学	lai yuan xian wang an zhen xiao ling gen xiao xue	152
涞源县王安镇杏树沟小学	lai yuan xian wang an zhen xing shu gou xiao xue	154
涞源县王安镇闫家庄小学	lai yuan xian wang an zhen yan jia zhuang xiao xue	166
涞源县王安镇殷家堡小学	lai yuan xian wang an zhen yin jia bao xiao xue	144
涞源县王安镇银山口小学	lai yuan xian wang an zhen yin shan kou xiao xue	142
涞源县王安镇中学	lai yuan xian wang an zhen zhong xue	191
涞源县乌龙沟乡大庄小学	lai yuan xian wu long gou xiang da zhuang xiao xue	124
涞源县乌龙沟乡邓庄小学	lai yuan xian wu long gou xiang deng zhuang xiao xue	125
涞源县乌龙沟乡煤窑小学	lai yuan xian wu long gou xiang mei yao xiao xue	90
涞源县乌龙沟乡小庄小学	lai yuan xian wu long gou xiang xiao zhuang xiao xue	88
涞源县乌龙沟乡中心小学	lai yuan xian wu long gou xiang zhong xin xiao xue	126
涞源县烟煤洞乡白窑小学	lai yuan xian yan mei dong xiang bai yao xiao xue	132
涞源县烟煤洞乡曹家沟小学	lai yuan xian yan mei dong xiang cao jia gou xiao xue	185
涞源县烟煤洞乡井家滩小学	lai yuan xian yan mei dong xiang jing jia tan xiao xue	104
涞源县烟煤洞乡南李家庄小学	lai yuan xian yan mei dong xiang nan li jia zhuang xiao xue	131
涞源县烟煤洞乡五道庙小学	lai yuan xian yan mei dong xiang wu dao miao xiao xue	133
涞源县烟煤洞乡中心小学	lai yuan xian yan mei dong xiang zhong xin xiao xue	130
涞源县燕赵小学	lai yuan xian yan zhao xiao xue	169
涞源县杨家庄镇浮图峪小学	lai yuan xian yang jia zhuang zhen fu tu yu xiao xue	85
涞源县杨家庄镇高家庄小学	lai yuan xian yang jia zhuang zhen gao jia zhuang xiao xue	83
涞源县杨家庄镇仝川小学	lai yuan xian yang jia zhuang zhen tong chuan xiao xue	95
涞源县杨家庄镇小河小学	lai yuan xian yang jia zhuang zhen xiao he xiao xue	86
涞源县杨家庄镇杨家庄小学	lai yuan xian yang jia zhuang zhen yang jia zhuang xiao xue	84
涞源县杨家庄镇育成小学	lai yuan xian yang jia zhuang zhen yu cheng xiao xue	73
涞源县杨家庄镇中心小学	lai yuan xian yang jia zhuang zhen zhong xin xiao xue	111
涞源县杨家庄镇周家庄小学	lai yuan xian yang jia zhuang zhen zhou jia zhuang xiao xue	82
涞源县易衡联和学校	lai yuan xian yi heng lian he xue xiao	195
涞源县银坊镇北坛小学	lai yuan xian yin fang zhen bei tan xiao xue	48
涞源县银坊镇合婚台小学	lai yuan xian yin fang zhen he hun tai xiao xue	49
涞源县银坊镇黄土岭小学	lai yuan xian yin fang zhen huang tu ling xiao xue	34
涞源县银坊镇吉河小学	lai yuan xian yin fang zhen ji he xiao xue	92
涞源县银坊镇南道神小学	lai yuan xian yin fang zhen nan dao shen xiao xue	87
涞源县银坊镇南沟小学	lai yuan xian yin fang zhen nan gou xiao xue	51
涞源县银坊镇碾盘小学	lai yuan xian yin fang zhen nian pan xiao xue	93
涞源县银坊镇牛栏小学	lai yuan xian yin fang zhen niu lan xiao xue	50
涞源县银坊镇上铺小学	lai yuan xian yin fang zhen shang pu xiao xue	52
涞源县银坊镇上下台小学	lai yuan xian yin fang zhen shang xia tai xiao xue	184
涞源县银坊镇司格庄小学	lai yuan xian yin fang zhen si ge zhuang xiao xue	94
涞源县银坊镇松树台小学	lai yuan xian yin fang zhen song shu tai xiao xue	53
涞源县银坊镇杏树台小学	lai yuan xian yin fang zhen xing shu tai xiao xue	47
涞源县银坊镇雁宿崖小学	lai yuan xian yin fang zhen yan su ya xiao xue	32
涞源县银坊镇银炉台小学	lai yuan xian yin fang zhen yin lu tai xiao xue	37
涞源县银坊镇营尔小学	lai yuan xian yin fang zhen ying er xiao xue	46
涞源县银坊镇玉皇安小学	lai yuan xian yin fang zhen yu huang an xiao xue	35
涞源县银坊镇玉皇沟小学	lai yuan xian yin fang zhen yu huang gou xiao xue	36
涞源县银坊镇张家坟小学	lai yuan xian yin fang zhen zhang jia fen xiao xue	91
涞源县银坊镇长祥沟小学	lai yuan xian yin fang zhen zhang xiang gou xiao xue	33
涞源县银坊镇中学	lai yuan xian yin fang zhen zhong xue	178
涞源县职业技术教育中心	lai yuan xian zhi ye ji shu jiao yu zhong xin	203
涞源县走马驿镇白道安小学	lai yuan xian zou ma yi zhen bai dao an xiao xue	105
涞源县走马驿镇东村小学	lai yuan xian zou ma yi zhen dong cun xiao xue	121
涞源县走马驿镇高家台小学	lai yuan xian zou ma yi zhen gao jia tai xiao xue	115
涞源县走马驿镇花园小学	lai yuan xian zou ma yi zhen hua yuan xiao xue	186
涞源县走马驿镇祭刀岭小学	lai yuan xian zou ma yi zhen ji dao ling xiao xue	107
涞源县走马驿镇教场小学	lai yuan xian zou ma yi zhen jiao chang xiao xue	109
涞源县走马驿镇吕家庄小学	lai yuan xian zou ma yi zhen lv jia zhuang xiao xue	119
涞源县走马驿镇蒲头小学	lai yuan xian zou ma yi zhen pu tou xiao xue	116
涞源县走马驿镇泉厂背小学	lai yuan xian zou ma yi zhen quan chang bei xiao xue	114
涞源县走马驿镇石城墩小学	lai yuan xian zou ma yi zhen shi cheng dun xiao xue	106
涞源县走马驿镇松树柁小学	lai yuan xian zou ma yi zhen song shu duo xiao xue	118
涞源县走马驿镇五间房小学	lai yuan xian zou ma yi zhen wu jian fang xiao xue	108
涞源县走马驿镇五门小学	lai yuan xian zou ma yi zhen wu men xiao xue	120
涞源县走马驿镇西村小学	lai yuan xian zou ma yi zhen xi cun xiao xue	122
涞源县走马驿镇燕窝小学	lai yuan xian zou ma yi zhen yan wo xiao xue	117
涞源县走马驿镇窑峪口小学	lai yuan xian zou ma yi zhen yao yu kou xiao xue	110
涞源县走马驿镇中心小学	lai yuan xian zou ma yi zhen zhong xin xiao xue	159
