# 文件名：深圳公交.scel
# 词库名：深圳公交
# 词库分类：道路交通地名
# 词库描述：
# 词条样例：鹊山路口站布龙路坪山民乐福站 三和百货站坪洲百货坪地市场站 群贤花园站坪山中学爱汀堡站 上塘路口永安百货站盛平天桥站 沙元埔民治小学站上水径站
# 词条数量：56

华为站南山港隆城站鼎尚华庭站	hua wei zhan nan shan gang long cheng zhan ding shang hua ting zhan	55
金威大厦站华新村站	jin wei da sha zhan hua xin cun zhan	56
荔枝园站景田沃尔玛站	li zhi yuan zhan jing tian wo er ma zhan	54
鹊山路口站布龙路坪山民乐福站	que shan lu kou zhan bu long lu ping shan min le fu zhan	53
群贤花园站坪山中学爱汀堡站	qun xian hua yuan zhan ping shan zhong xue ai ting bao zhan	52
三和百货站坪洲百货坪地市场站	san he bai huo zhan ping zhou bai huo ping di shi chang zhan	51
沙边路口站钱排村站	sha bian lu kou zhan qian pai cun zhan	50
沙井佳华佳华天桥站荣超花园站	sha jing jia hua jia hua tian qiao zhan rong chao hua yuan zhan	49
沙井万佳中心路口站沙湾检查站	sha jing wan jia zhong xin lu kou zhan sha wan jian cha zhan	48
沙浦站山厦路口山厦医院站	sha pu zhan shan sha lu kou shan sha yi yuan zhan	47
沙吓站上木古村站平新北路	sha xia zhan shang mu gu cun zhan ping xin bei lu	46
沙元埔民治小学站上水径站	sha yuan pu min zhi xiao xue zhan shang shui jing zhan	45
上合市场站尚景欣园站	shang he shi chang zhan shang jing xin yuan zhan	44
上寮上南酒店站深坑社区站	shang liao shang nan jiu dian zhan shen keng she qu zhan	43
上塘路口永安百货站盛平天桥站	shang tang lu kou yong an bai huo zhan sheng ping tian qiao zhan	42
上油松村站狮头岭村委站	shang you song cun zhan shi tou ling cun wei zhan	41
深业新岸线站石灰围站	shen ye xin an xian zhan shi hui wei zhan	40
世纪春城站水晶之城坳背路口站	shi ji chun cheng zhan shui jing zhi cheng ao bei lu kou zhan	37
石围站水岸新都新梓学校站	shi wei zhan shui an xin du xin zi xue xiao zhan	39
石岩湖渡假村总站水斗新村站	shi yan hu du jia cun zong zhan shui dou xin cun zhan	38
水尾站四季花城站	shui wei zhan si ji hua cheng zhan	36
松岗宝利来站松元市场站	song gang bao li lai zhan song yuan shi chang zhan	35
松元市场站汤坑村总站	song yuan shi chang zhan tang keng cun zong zhan	34
松仔园站无站台天安花园站	song zai yuan zhan wu zhan tai tian an hua yuan zhan	33
潭头西部工业区总站田脚站坑梓	tan tou xi bu gong ye qu zong zhan tian jiao zhan keng zi	32
塘头路口站松白路田头村总站	tang tou lu kou zhan song bai lu tian tou cun zong zhan	31
塘尾站田心村委站	tang wei zhan tian xin cun wei zhan	30
桃源居站前进二路万科城站	tao yuan ju zhan qian jin er lu wan ke cheng zhan	29
田寮路口站望牛岗站	tian liao lu kou zhan wang niu gang zhan	28
同仁妇科医院站下水径站	tong ren fu ke yi yuan zhan xia shui jing zhan	27
万家灯火站象角塘站雪岗北路	wan jia deng huo zhan xiang jiao tang zhan xue gang bei lu	26
下横朗新村站星光之约站	xia heng lang xin cun zhan xing guang zhi yue zhan	25
香缇雅苑站秀峰路口站吉华路	xiang ti ya yuan zhan xiu feng lu kou zhan ji hua lu	24
新安公园站雅兰集团丹竹头村站	xin an gong yuan zhan ya lan ji tuan dan zhu tou cun zhan	23
新百丽站杨美村河背村站	xin bai li zhan yang mei cun he bei cun zhan	22
新围新村站茵悦之生站	xin wei xin cun zhan yin yue zhi sheng zhan	21
星光之约站樟树布社区站	xing guang zhi yue zhan zhang shu bu she qu zhan	20
阳光工业区站竹坑村委站翠景路	yang guang gong ye qu zhan zhu keng cun wei zhan cui jing lu	18
羊台山站中海怡翠站	yang tai shan zhan zhong hai yi cui zhan	19
银泉花园站人民北路紫薇花园站	yin quan hua yuan zhan ren min bei lu zi wei hua yuan zhan	17
银田工业区站宝安大道	yin tian gong ye qu zhan bao an da dao	16
应人石路口站	ying ren shi lu kou zhan	15
滢水山庄站	ying shui shan zhuang zhan	14
永联学校帝皇酒店站	yong lian xue xiao di huang jiu dian zhan	13
油松工业区站	you song gong ye qu zhan	12
玉律玉律大门站无站台	yu lv yu lv da men zhan wu zhan tai	11
章阁市场站	zhang ge shi chang zhan	10
樟坑径樟坑径下围路口站	zhang keng jing zhang keng jing xia wei lu kou zhan	9
樟坑站	zhang keng zhan	8
中航格澜郡站环观南路	zhong hang ge lan jun zhan huan guan nan lu	7
中华商贸城三围路口站	zhong hua shang mao cheng san wei lu kou zhan	6
中南花园站新城联检站	zhong nan hua yuan zhan xin cheng lian jian zhan	5
中商花园站	zhong shang hua yuan zhan	4
钟屋站	zhong wu zhan	2
中英公学站	zhong ying gong xue zhan	3
竹村拥军站	zhu cun yong jun zhan	1
