# 文件名：罗岗地址名称.scel
# 词库名：脗脼赂脷碌脴脰路脙没鲁脝
# 词库分类：脨脨脮镁脟酶禄庐碌脴脙没
# 词库描述：
# 词条样例：白莲东街 白莲西街九巷 白莲西街十巷 白头岭东街四横路 垂思街 洞隐北街
# 词条数量：396

白莲东街	bai lian dong jie	395
白莲东街三巷	bai lian dong jie san xiang	394
白莲东街四巷	bai lian dong jie si xiang	393
白莲南街	bai lian nan jie	392
白莲西街	bai lian xi jie	391
白莲西街八巷	bai lian xi jie ba xiang	390
白莲西街九巷	bai lian xi jie jiu xiang	389
白莲西街六巷	bai lian xi jie liu xiang	388
白莲西街七巷	bai lian xi jie qi xiang	387
白莲西街三巷	bai lian xi jie san xiang	386
白莲西街十巷	bai lian xi jie shi xiang	385
白头岭北街	bai tou ling bei jie	384
白头岭北街十巷	bai tou ling bei jie shi xiang	383
白头岭东街	bai tou ling dong jie	382
白头岭东街四横路	bai tou ling dong jie si heng lu	381
垂思街	chui si jie	380
垂思街二十巷	chui si jie er shi xiang	379
洞隐北街	dong yin bei jie	378
洞隐东街	dong yin dong jie	377
洞隐东街十四巷	dong yin dong jie shi si xiang	376
洞隐街	dong yin jie	375
风水基街	feng shui ji jie	374
公仔岭街	gong zai ling jie	373
加石路	jia shi lu	372
联庆街	lian qing jie	371
联庆街十八巷	lian qing jie shi ba xiang	370
禄清大街	lu qing da jie	369
禄清大街二巷	lu qing da jie er xiang	368
禄清大街六巷	lu qing da jie liu xiang	367
禄清大街五巷	lu qing da jie wu xiang	366
禄清大街一巷	lu qing da jie yi xiang	365
禄清南街	lu qing nan jie	364
禄清正街	lu qing zheng jie	363
罗岗耙田头路	luo gang ba tian tou lu	119
罗岗白莲东街二巷	luo gang bai lian dong jie er xiang	362
罗岗白莲东街三巷	luo gang bai lian dong jie san xiang	361
罗岗白莲东街四巷	luo gang bai lian dong jie si xiang	360
罗岗白莲东街一巷	luo gang bai lian dong jie yi xiang	359
罗岗白莲西街八巷	luo gang bai lian xi jie ba xiang	358
罗岗白莲西街二巷	luo gang bai lian xi jie er xiang	357
罗岗白莲西街九巷	luo gang bai lian xi jie jiu xiang	356
罗岗白莲西街六巷	luo gang bai lian xi jie liu xiang	355
罗岗白莲西街七巷	luo gang bai lian xi jie qi xiang	354
罗岗白莲西街三巷	luo gang bai lian xi jie san xiang	353
罗岗白莲西街十巷	luo gang bai lian xi jie shi xiang	352
罗岗白莲西街十一巷	luo gang bai lian xi jie shi yi xiang	351
罗岗白莲西街四巷	luo gang bai lian xi jie si xiang	350
罗岗白莲西街五巷	luo gang bai lian xi jie wu xiang	349
罗岗白莲西街一巷	luo gang bai lian xi jie yi xiang	348
罗岗白头岭北街八巷	luo gang bai tou ling bei jie ba xiang	347
罗岗白头岭北街二巷	luo gang bai tou ling bei jie er xiang	346
罗岗白头岭北街九巷	luo gang bai tou ling bei jie jiu xiang	345
罗岗白头岭北街六巷	luo gang bai tou ling bei jie liu xiang	344
罗岗白头岭北街七巷	luo gang bai tou ling bei jie qi xiang	343
罗岗白头岭北街三巷	luo gang bai tou ling bei jie san xiang	342
罗岗白头岭北街十巷	luo gang bai tou ling bei jie shi xiang	341
罗岗白头岭北街五巷	luo gang bai tou ling bei jie wu xiang	340
罗岗白头岭北街一巷	luo gang bai tou ling bei jie yi xiang	339
罗岗白头岭东街八巷	luo gang bai tou ling dong jie ba xiang	338
罗岗白头岭东街二巷	luo gang bai tou ling dong jie er xiang	337
罗岗白头岭东街九巷	luo gang bai tou ling dong jie jiu xiang	336
罗岗白头岭东街六巷	luo gang bai tou ling dong jie liu xiang	335
罗岗白头岭东街七巷	luo gang bai tou ling dong jie qi xiang	334
罗岗白头岭东街三巷	luo gang bai tou ling dong jie san xiang	333
罗岗白头岭东街十二巷	luo gang bai tou ling dong jie shi er xiang	332
罗岗白头岭东街十巷	luo gang bai tou ling dong jie shi xiang	331
罗岗白头岭东街十一巷	luo gang bai tou ling dong jie shi yi xiang	330
罗岗白头岭东街四巷	luo gang bai tou ling dong jie si xiang	329
罗岗白头岭东街五巷	luo gang bai tou ling dong jie wu xiang	328
罗岗白头岭东街一巷	luo gang bai tou ling dong jie yi xiang	327
罗岗白头岭西二巷	luo gang bai tou ling xi er xiang	326
罗岗白头岭西九巷	luo gang bai tou ling xi jiu xiang	325
罗岗白头岭西六巷	luo gang bai tou ling xi liu xiang	324
罗岗白头岭西三巷	luo gang bai tou ling xi san xiang	323
罗岗白头岭西十二巷	luo gang bai tou ling xi shi er xiang	322
罗岗白头岭西十三巷	luo gang bai tou ling xi shi san xiang	321
罗岗白头岭西十巷	luo gang bai tou ling xi shi xiang	320
罗岗白头岭西十一巷	luo gang bai tou ling xi shi yi xiang	319
罗岗白头岭中二巷	luo gang bai tou ling zhong er xiang	318
罗岗白头岭中三巷	luo gang bai tou ling zhong san xiang	317
罗岗白头岭中四巷	luo gang bai tou ling zhong si xiang	316
罗岗白头岭中五巷	luo gang bai tou ling zhong wu xiang	315
罗岗白头岭中一巷	luo gang bai tou ling zhong yi xiang	314
罗岗北街	luo gang bei jie	313
罗岗北街东八巷	luo gang bei jie dong ba xiang	312
罗岗北街东二巷	luo gang bei jie dong er xiang	311
罗岗北街东六巷	luo gang bei jie dong liu xiang	310
罗岗北街东七巷	luo gang bei jie dong qi xiang	309
罗岗北街东三巷	luo gang bei jie dong san xiang	308
罗岗北街东四巷	luo gang bei jie dong si xiang	307
罗岗北街东五巷	luo gang bei jie dong wu xiang	306
罗岗北街东一巷	luo gang bei jie dong yi xiang	305
罗岗北街西八巷	luo gang bei jie xi ba xiang	304
罗岗北街西二巷	luo gang bei jie xi er xiang	303
罗岗北街西九巷	luo gang bei jie xi jiu xiang	302
罗岗北街西六巷	luo gang bei jie xi liu xiang	301
罗岗北街西七巷	luo gang bei jie xi qi xiang	300
罗岗北街西三巷	luo gang bei jie xi san xiang	299
罗岗北街西十二巷	luo gang bei jie xi shi er xiang	298
罗岗北街西十三巷	luo gang bei jie xi shi san xiang	297
罗岗北街西十巷	luo gang bei jie xi shi xiang	296
罗岗北街西十一巷	luo gang bei jie xi shi yi xiang	295
罗岗北街西四巷	luo gang bei jie xi si xiang	294
罗岗北街西五巷	luo gang bei jie xi wu xiang	293
罗岗北街西一巷	luo gang bei jie xi yi xiang	292
罗岗垂思街八巷	luo gang chui si jie ba xiang	291
罗岗垂思街东二十巷	luo gang chui si jie dong er shi xiang	290
罗岗垂思街东九巷	luo gang chui si jie dong jiu xiang	289
罗岗垂思街东十八巷	luo gang chui si jie dong shi ba xiang	288
罗岗垂思街东十二巷	luo gang chui si jie dong shi er xiang	287
罗岗垂思街东十九巷	luo gang chui si jie dong shi jiu xiang	286
罗岗垂思街东十六巷	luo gang chui si jie dong shi liu xiang	285
罗岗垂思街东十七巷	luo gang chui si jie dong shi qi xiang	284
罗岗垂思街东十三巷	luo gang chui si jie dong shi san xiang	283
罗岗垂思街东十四巷	luo gang chui si jie dong shi si xiang	282
罗岗垂思街东十五巷	luo gang chui si jie dong shi wu xiang	281
罗岗垂思街东十巷	luo gang chui si jie dong shi xiang	280
罗岗垂思街东十一巷	luo gang chui si jie dong shi yi xiang	279
罗岗垂思街二十巷	luo gang chui si jie er shi xiang	278
罗岗垂思街二巷	luo gang chui si jie er xiang	277
罗岗垂思街九巷	luo gang chui si jie jiu xiang	276
罗岗垂思街六巷	luo gang chui si jie liu xiang	275
罗岗垂思街七巷	luo gang chui si jie qi xiang	274
罗岗垂思街十八巷	luo gang chui si jie shi ba xiang	273
罗岗垂思街十二巷	luo gang chui si jie shi er xiang	272
罗岗垂思街十九巷	luo gang chui si jie shi jiu xiang	271
罗岗垂思街十七巷	luo gang chui si jie shi qi xiang	270
罗岗垂思街十三巷	luo gang chui si jie shi san xiang	269
罗岗垂思街十四巷	luo gang chui si jie shi si xiang	268
罗岗垂思街十五巷	luo gang chui si jie shi wu xiang	267
罗岗垂思街十巷	luo gang chui si jie shi xiang	266
罗岗垂思街十一巷	luo gang chui si jie shi yi xiang	265
罗岗垂思街四巷	luo gang chui si jie si xiang	264
罗岗垂思街五巷	luo gang chui si jie wu xiang	263
罗岗垂思街一巷	luo gang chui si jie yi xiang	262
罗岗东边岭八巷	luo gang dong bian ling ba xiang	261
罗岗东边岭二巷	luo gang dong bian ling er xiang	260
罗岗东边岭九巷	luo gang dong bian ling jiu xiang	259
罗岗东边岭七巷	luo gang dong bian ling qi xiang	258
罗岗东边岭三巷	luo gang dong bian ling san xiang	257
罗岗东边岭十巷	luo gang dong bian ling shi xiang	256
罗岗东边岭十一巷	luo gang dong bian ling shi yi xiang	255
罗岗东边岭五巷	luo gang dong bian ling wu xiang	254
罗岗东边岭一巷	luo gang dong bian ling yi xiang	253
罗岗东边岭直街	luo gang dong bian ling zhi jie	252
罗岗洞隐北街八巷	luo gang dong yin bei jie ba xiang	251
罗岗洞隐北街二巷	luo gang dong yin bei jie er xiang	250
罗岗洞隐北街九巷	luo gang dong yin bei jie jiu xiang	249
罗岗洞隐北街六巷	luo gang dong yin bei jie liu xiang	248
罗岗洞隐北街七巷	luo gang dong yin bei jie qi xiang	247
罗岗洞隐北街三巷	luo gang dong yin bei jie san xiang	246
罗岗洞隐北街十巷	luo gang dong yin bei jie shi xiang	245
罗岗洞隐北街十一巷	luo gang dong yin bei jie shi yi xiang	244
罗岗洞隐北街四巷	luo gang dong yin bei jie si xiang	243
罗岗洞隐北街五巷	luo gang dong yin bei jie wu xiang	242
罗岗洞隐北街一巷	luo gang dong yin bei jie yi xiang	241
罗岗洞隐东街八巷	luo gang dong yin dong jie ba xiang	240
罗岗洞隐东街二十二巷	luo gang dong yin dong jie er shi er xiang	239
罗岗洞隐东街二十三巷	luo gang dong yin dong jie er shi san xiang	238
罗岗洞隐东街二十四巷	luo gang dong yin dong jie er shi si xiang	237
罗岗洞隐东街二十巷	luo gang dong yin dong jie er shi xiang	236
罗岗洞隐东街二十一巷	luo gang dong yin dong jie er shi yi xiang	235
罗岗洞隐东街二巷	luo gang dong yin dong jie er xiang	234
罗岗洞隐东街九巷	luo gang dong yin dong jie jiu xiang	233
罗岗洞隐东街六巷	luo gang dong yin dong jie liu xiang	232
罗岗洞隐东街七巷	luo gang dong yin dong jie qi xiang	231
罗岗洞隐东街三巷	luo gang dong yin dong jie san xiang	230
罗岗洞隐东街十八巷	luo gang dong yin dong jie shi ba xiang	229
罗岗洞隐东街十二巷	luo gang dong yin dong jie shi er xiang	228
罗岗洞隐东街十九巷	luo gang dong yin dong jie shi jiu xiang	227
罗岗洞隐东街十六巷	luo gang dong yin dong jie shi liu xiang	226
罗岗洞隐东街十七巷	luo gang dong yin dong jie shi qi xiang	225
罗岗洞隐东街十四巷	luo gang dong yin dong jie shi si xiang	224
罗岗洞隐东街十五巷	luo gang dong yin dong jie shi wu xiang	223
罗岗洞隐东街十巷	luo gang dong yin dong jie shi xiang	222
罗岗洞隐东街十一巷	luo gang dong yin dong jie shi yi xiang	221
罗岗洞隐东街五巷	luo gang dong yin dong jie wu xiang	220
罗岗洞隐东街一巷	luo gang dong yin dong jie yi xiang	219
罗岗洞隐街八巷	luo gang dong yin jie ba xiang	218
罗岗洞隐街二巷	luo gang dong yin jie er xiang	217
罗岗洞隐街六巷	luo gang dong yin jie liu xiang	216
罗岗洞隐街七巷	luo gang dong yin jie qi xiang	215
罗岗洞隐街三巷	luo gang dong yin jie san xiang	214
罗岗洞隐街四巷	luo gang dong yin jie si xiang	213
罗岗洞隐街五巷	luo gang dong yin jie wu xiang	212
罗岗洞隐街一巷	luo gang dong yin jie yi xiang	211
罗岗高才街	luo gang gao cai jie	210
罗岗高才街二巷	luo gang gao cai jie er xiang	209
罗岗高才街九巷	luo gang gao cai jie jiu xiang	208
罗岗高才街三巷	luo gang gao cai jie san xiang	207
罗岗高才街四巷	luo gang gao cai jie si xiang	206
罗岗高才街五巷	luo gang gao cai jie wu xiang	205
罗岗高才街一巷	luo gang gao cai jie yi xiang	204
罗岗拱北街	luo gang gong bei jie	196
罗岗拱北街二巷	luo gang gong bei jie er xiang	195
罗岗拱北街六巷	luo gang gong bei jie liu xiang	194
罗岗拱北街三巷	luo gang gong bei jie san xiang	193
罗岗拱北街四巷	luo gang gong bei jie si xiang	192
罗岗拱北街五巷	luo gang gong bei jie wu xiang	191
罗岗拱北街一巷	luo gang gong bei jie yi xiang	190
罗岗公仔岭街东九巷	luo gang gong zai ling jie dong jiu xiang	203
罗岗公仔岭街西六巷	luo gang gong zai ling jie xi liu xiang	202
罗岗公仔岭街西七巷	luo gang gong zai ling jie xi qi xiang	201
罗岗公仔岭街西三巷	luo gang gong zai ling jie xi san xiang	200
罗岗公仔岭街西四巷	luo gang gong zai ling jie xi si xiang	199
罗岗公仔岭街西五巷	luo gang gong zai ling jie xi wu xiang	198
罗岗公仔岭街西一巷	luo gang gong zai ling jie xi yi xiang	197
罗岗狗梅岭路	luo gang gou mei ling lu	189
罗岗虎头岭路	luo gang hu tou ling lu	188
罗岗环岗北路	luo gang huan gang bei lu	187
罗岗环岗北路二横路	luo gang huan gang bei lu er heng lu	186
罗岗环岗北路四横路	luo gang huan gang bei lu si heng lu	185
罗岗环岗北路五横路	luo gang huan gang bei lu wu heng lu	184
罗岗环岗二路	luo gang huan gang er lu	183
罗岗环岗一路	luo gang huan gang yi lu	182
罗岗加石路	luo gang jia shi lu	181
罗岗加石路三巷	luo gang jia shi lu san xiang	180
罗岗加石路一巷	luo gang jia shi lu yi xiang	179
罗岗加石南路	luo gang jia shi nan lu	178
罗岗街	luo gang jie	177
罗岗联庆街八巷	luo gang lian qing jie ba xiang	176
罗岗联庆街二十巷	luo gang lian qing jie er shi xiang	175
罗岗联庆街二十一巷	luo gang lian qing jie er shi yi xiang	174
罗岗联庆街九巷	luo gang lian qing jie jiu xiang	173
罗岗联庆街七巷	luo gang lian qing jie qi xiang	172
罗岗联庆街十八巷	luo gang lian qing jie shi ba xiang	171
罗岗联庆街十二巷	luo gang lian qing jie shi er xiang	170
罗岗联庆街十九巷	luo gang lian qing jie shi jiu xiang	169
罗岗联庆街十六巷	luo gang lian qing jie shi liu xiang	168
罗岗联庆街十七巷	luo gang lian qing jie shi qi xiang	167
罗岗联庆街十三巷	luo gang lian qing jie shi san xiang	166
罗岗联庆街十四巷	luo gang lian qing jie shi si xiang	165
罗岗联庆街十五巷	luo gang lian qing jie shi wu xiang	164
罗岗联庆街十巷	luo gang lian qing jie shi xiang	163
罗岗联庆街十一巷	luo gang lian qing jie shi yi xiang	162
罗岗龙壁巷	luo gang long bi xiang	161
罗岗禄清大街八巷	luo gang lu qing da jie ba xiang	160
罗岗禄清大街二巷	luo gang lu qing da jie er xiang	159
罗岗禄清大街九巷	luo gang lu qing da jie jiu xiang	158
罗岗禄清大街六巷	luo gang lu qing da jie liu xiang	157
罗岗禄清大街七巷	luo gang lu qing da jie qi xiang	156
罗岗禄清大街三巷	luo gang lu qing da jie san xiang	155
罗岗禄清大街十三巷	luo gang lu qing da jie shi san xiang	154
罗岗禄清大街十四巷	luo gang lu qing da jie shi si xiang	153
罗岗禄清大街十巷	luo gang lu qing da jie shi xiang	152
罗岗禄清大街十一巷	luo gang lu qing da jie shi yi xiang	151
罗岗禄清大街四巷	luo gang lu qing da jie si xiang	150
罗岗禄清大街五巷	luo gang lu qing da jie wu xiang	149
罗岗禄清大街一巷	luo gang lu qing da jie yi xiang	148
罗岗禄清南街	luo gang lu qing nan jie	147
罗岗禄清正街八巷	luo gang lu qing zheng jie ba xiang	146
罗岗禄清正街九巷	luo gang lu qing zheng jie jiu xiang	145
罗岗禄清正街六巷	luo gang lu qing zheng jie liu xiang	144
罗岗禄清正街七巷	luo gang lu qing zheng jie qi xiang	143
罗岗禄清正街三巷	luo gang lu qing zheng jie san xiang	142
罗岗禄清正街十二巷	luo gang lu qing zheng jie shi er xiang	141
罗岗禄清正街十三巷	luo gang lu qing zheng jie shi san xiang	140
罗岗禄清正街十四巷	luo gang lu qing zheng jie shi si xiang	139
罗岗禄清正街十五巷	luo gang lu qing zheng jie shi wu xiang	138
罗岗禄清正街十一巷	luo gang lu qing zheng jie shi yi xiang	137
罗岗禄清正街五巷	luo gang lu qing zheng jie wu xiang	136
罗岗禄清正街一巷	luo gang lu qing zheng jie yi xiang	135
罗岗罗苑街	luo gang luo yuan jie	134
罗岗麦角岭北八巷	luo gang mai jiao ling bei ba xiang	133
罗岗麦角岭北二巷	luo gang mai jiao ling bei er xiang	132
罗岗麦角岭北九巷	luo gang mai jiao ling bei jiu xiang	131
罗岗麦角岭北六巷	luo gang mai jiao ling bei liu xiang	130
罗岗麦角岭北七巷	luo gang mai jiao ling bei qi xiang	129
罗岗麦角岭北三巷	luo gang mai jiao ling bei san xiang	128
罗岗麦角岭北四巷	luo gang mai jiao ling bei si xiang	127
罗岗麦角岭北五巷	luo gang mai jiao ling bei wu xiang	126
罗岗麦角岭北一巷	luo gang mai jiao ling bei yi xiang	125
罗岗麦角岭南二巷	luo gang mai jiao ling nan er xiang	124
罗岗麦角岭南一巷	luo gang mai jiao ling nan yi xiang	123
罗岗庙园街	luo gang miao yuan jie	122
罗岗庙园街四巷	luo gang miao yuan jie si xiang	121
罗岗木棉塘东路	luo gang mu mian tang dong lu	120
罗岗企路东路	luo gang qi lu dong lu	116
罗岗七星岗工业路	luo gang qi xing gang gong ye lu	118
罗岗七星岗路	luo gang qi xing gang lu	117
罗岗商垂大街南八巷	luo gang shang chui da jie nan ba xiang	115
罗岗商垂大街南二巷	luo gang shang chui da jie nan er xiang	114
罗岗商垂大街南九巷	luo gang shang chui da jie nan jiu xiang	113
罗岗商垂大街南六巷	luo gang shang chui da jie nan liu xiang	112
罗岗商垂大街南七巷	luo gang shang chui da jie nan qi xiang	111
罗岗商垂大街南三巷	luo gang shang chui da jie nan san xiang	110
罗岗商垂大街南十二巷	luo gang shang chui da jie nan shi er xiang	109
罗岗商垂大街南十三巷	luo gang shang chui da jie nan shi san xiang	108
罗岗商垂大街南十巷	luo gang shang chui da jie nan shi xiang	107
罗岗商垂大街南十一巷	luo gang shang chui da jie nan shi yi xiang	106
罗岗商垂大街南四巷	luo gang shang chui da jie nan si xiang	105
罗岗商垂大街南五巷	luo gang shang chui da jie nan wu xiang	104
罗岗商垂大街南一巷	luo gang shang chui da jie nan yi xiang	103
罗岗商垂街二巷	luo gang shang chui jie er xiang	102
罗岗商垂街三巷	luo gang shang chui jie san xiang	101
罗岗商垂街四巷	luo gang shang chui jie si xiang	100
罗岗商垂街五巷	luo gang shang chui jie wu xiang	99
罗岗商垂街一巷	luo gang shang chui jie yi xiang	98
罗岗商农东街	luo gang shang nong dong jie	97
罗岗商农东街八巷	luo gang shang nong dong jie ba xiang	96
罗岗商农东街二十巷	luo gang shang nong dong jie er shi xiang	95
罗岗商农东街二十一巷	luo gang shang nong dong jie er shi yi xiang	94
罗岗商农东街二巷	luo gang shang nong dong jie er xiang	93
罗岗商农东街九巷	luo gang shang nong dong jie jiu xiang	92
罗岗商农东街六巷	luo gang shang nong dong jie liu xiang	91
罗岗商农东街七巷	luo gang shang nong dong jie qi xiang	90
罗岗商农东街三巷	luo gang shang nong dong jie san xiang	89
罗岗商农东街十八巷	luo gang shang nong dong jie shi ba xiang	88
罗岗商农东街十二巷	luo gang shang nong dong jie shi er xiang	87
罗岗商农东街十九巷	luo gang shang nong dong jie shi jiu xiang	86
罗岗商农东街十七巷	luo gang shang nong dong jie shi qi xiang	85
罗岗商农东街十三巷	luo gang shang nong dong jie shi san xiang	84
罗岗商农东街十一巷	luo gang shang nong dong jie shi yi xiang	83
罗岗商农东街四巷	luo gang shang nong dong jie si xiang	82
罗岗商农东街五巷	luo gang shang nong dong jie wu xiang	81
罗岗商农东街一巷	luo gang shang nong dong jie yi xiang	80
罗岗商农南街	luo gang shang nong nan jie	79
罗岗商农西街	luo gang shang nong xi jie	78
罗岗商农西街八巷	luo gang shang nong xi jie ba xiang	77
罗岗商农西街二巷	luo gang shang nong xi jie er xiang	76
罗岗商农西街九巷	luo gang shang nong xi jie jiu xiang	75
罗岗商农西街六巷	luo gang shang nong xi jie liu xiang	74
罗岗商农西街七巷	luo gang shang nong xi jie qi xiang	73
罗岗商农西街三巷	luo gang shang nong xi jie san xiang	72
罗岗商农西街四巷	luo gang shang nong xi jie si xiang	71
罗岗商农西街五巷	luo gang shang nong xi jie wu xiang	70
罗岗商农西街一巷	luo gang shang nong xi jie yi xiang	69
罗岗商山东街二巷	luo gang shang shan dong jie er xiang	68
罗岗商山东街后巷	luo gang shang shan dong jie hou xiang	67
罗岗商山东街三巷	luo gang shang shan dong jie san xiang	66
罗岗商山东街四巷	luo gang shang shan dong jie si xiang	65
罗岗商山东街五巷	luo gang shang shan dong jie wu xiang	64
罗岗商山东街一巷	luo gang shang shan dong jie yi xiang	63
罗岗商山南街	luo gang shang shan nan jie	62
罗岗商山南街八巷	luo gang shang shan nan jie ba xiang	61
罗岗商山南街二巷	luo gang shang shan nan jie er xiang	60
罗岗商山南街九巷	luo gang shang shan nan jie jiu xiang	59
罗岗商山南街六巷	luo gang shang shan nan jie liu xiang	58
罗岗商山南街七巷	luo gang shang shan nan jie qi xiang	57
罗岗商山南街三巷	luo gang shang shan nan jie san xiang	56
罗岗商山南街十巷	luo gang shang shan nan jie shi xiang	55
罗岗商山南街四巷	luo gang shang shan nan jie si xiang	54
罗岗商山南街五巷	luo gang shang shan nan jie wu xiang	53
罗岗商山南街一巷	luo gang shang shan nan jie yi xiang	52
罗岗商山前街	luo gang shang shan qian jie	51
罗岗商山西街	luo gang shang shan xi jie	50
罗岗商山西街二巷	luo gang shang shan xi jie er xiang	49
罗岗商山西街三巷	luo gang shang shan xi jie san xiang	48
罗岗商山西街四巷	luo gang shang shan xi jie si xiang	47
罗岗商山西街五巷	luo gang shang shan xi jie wu xiang	46
罗岗商山西街一巷	luo gang shang shan xi jie yi xiang	45
罗岗狮子岭二横路	luo gang shi zi ling er heng lu	44
罗岗狮子岭路	luo gang shi zi ling lu	43
罗岗狮子岭四横路	luo gang shi zi ling si heng lu	42
罗岗新高增二路	luo gang xin gao zeng er lu	41
罗岗宗润北街	luo gang zong run bei jie	40
罗岗宗润北街八巷	luo gang zong run bei jie ba xiang	39
罗岗宗润北街二巷	luo gang zong run bei jie er xiang	38
罗岗宗润北街横一巷	luo gang zong run bei jie heng yi xiang	37
罗岗宗润北街九巷	luo gang zong run bei jie jiu xiang	36
罗岗宗润北街六巷	luo gang zong run bei jie liu xiang	35
罗岗宗润北街七巷	luo gang zong run bei jie qi xiang	34
罗岗宗润北街三巷	luo gang zong run bei jie san xiang	33
罗岗宗润北街十二巷	luo gang zong run bei jie shi er xiang	32
罗岗宗润北街十六巷	luo gang zong run bei jie shi liu xiang	31
罗岗宗润北街十七巷	luo gang zong run bei jie shi qi xiang	30
罗岗宗润北街十三巷	luo gang zong run bei jie shi san xiang	29
罗岗宗润北街十四巷	luo gang zong run bei jie shi si xiang	28
罗岗宗润北街十五巷	luo gang zong run bei jie shi wu xiang	27
罗岗宗润北街十巷	luo gang zong run bei jie shi xiang	26
罗岗宗润北街十一巷	luo gang zong run bei jie shi yi xiang	25
罗岗宗润北街四巷	luo gang zong run bei jie si xiang	24
罗岗宗润北街五巷	luo gang zong run bei jie wu xiang	23
罗岗宗润北街一巷	luo gang zong run bei jie yi xiang	22
罗岗宗润南街	luo gang zong run nan jie	21
罗岗宗润南街二巷	luo gang zong run nan jie er xiang	20
罗岗宗润南街九巷	luo gang zong run nan jie jiu xiang	19
罗岗宗润南街六巷	luo gang zong run nan jie liu xiang	18
罗岗宗润南街七巷	luo gang zong run nan jie qi xiang	17
罗岗宗润南街三巷	luo gang zong run nan jie san xiang	16
罗岗宗润南街四巷	luo gang zong run nan jie si xiang	15
罗岗宗润南街五巷	luo gang zong run nan jie wu xiang	14
罗岗宗润南街一巷	luo gang zong run nan jie yi xiang	13
麦角岭南一巷	mai jiao ling nan yi xiang	12
商垂街	shang chui jie	11
商农东街	shang nong dong jie	10
商山东街	shang shan dong jie	9
商山东街后巷	shang shan dong jie hou xiang	8
商山南街四巷	shang shan nan jie si xiang	7
新石路	xin shi lu	6
原始版	yuan shi ban	396
织萝村路	zhi luo cun lu	5
织萝村路二横路	zhi luo cun lu er heng lu	4
织萝村路三横路	zhi luo cun lu san heng lu	3
织萝村路五横路	zhi luo cun lu wu heng lu	2
宗润北街七巷	zong run bei jie qi xiang	1
