# 文件名：陈巴尔虎.scel
# 词库名：陈巴尔虎
# 词库分类：行政区划地名
# 词库描述：
# 词条样例：巴彦社区 多兰社区 完工镇 乌布日诺尔嘎查 查干诺尔嘎查 额尔敦乌拉嘎查
# 词条数量：43

阿尔山嘎查	a er shan ga cha	11
安格尔图嘎查	an ge er tu ga cha	31
巴彦库任镇	ba yan ku ren zhen	43
巴彦社区	ba yan she qu	41
白音布日德嘎查	bai yin bu ri de ga cha	36
白音哈达嘎查	bai yin ha da ga cha	16
白音哈达苏木	bai yin ha da su mu	20
白音乌拉嘎查	bai yin wu la ga cha	25
宝日汗图嘎查	bao ri han tu ga cha	32
宝日希勒镇	bao ri xi le zhen	8
比力图嘎查	bi li tu ga cha	14
布敦呼舒嘎查	bu dun hu shu ga cha	5
查干诺尔嘎查	cha gan nuo er ga cha	28
东能化工有限公司	dong neng hua gong you xian gong si	7
东乌珠尔苏木	dong wu zhu er su mu	29
多兰社区	duo lan she qu	39
额尔敦乌拉嘎查	e er dun wu la ga cha	26
鄂温克苏木	e wen ke su mu	15
格根胡舒嘎查	ge gen hu shu ga cha	17
国华电厂备用电源	guo hua dian chang bei yong dian yuan	6
哈吉嘎查	ha ji ga cha	10
哈日干图嘎查	ha ri gan tu ga cha	33
哈日若尔嘎查	ha ri ruo er ga cha	35
哈腾胡硕嘎查	ha teng hu shuo ga cha	34
海拉图嘎查	hai la tu ga cha	27
呼和道布嘎查	hu he dao bu ga cha	18
呼和温都尔嘎查	hu he wen dou er ga cha	19
辉屯嘎查	hui tun ga cha	9
金新化工	jin xin hua gong	3
库热格太嘎查	ku re ge tai ga cha	4
孟根诺尔嘎查	meng gen nuo er ga cha	12
那吉嘎查	na ji ga cha	13
奇克登嘎查	qi ke deng ga cha	23
萨如拉塔拉嘎查	sa ru la ta la ga cha	22
苏优乐社区	su you le she qu	40
图布新社区	tu bu xin she qu	42
完工嘎查	wan gong ga cha	37
完工镇	wan gong zhen	38
乌布日诺尔嘎查	wu bu ri nuo er ga cha	30
乌珠尔嘎查	wu zhu er ga cha	21
西乌珠尔苏木	xi wu zhu er su mu	24
谢尔塔拉铁锌矿	xie er ta la tie xin kuang	1
谢尔塔拉镇	xie er ta la zhen	2
