# 文件名：《唐寅诗集》.scel
# 词库名：《唐寅诗集》
# 词库分类：诗词歌赋
# 词库描述：
# 词条样例：折来对镜化红妆 佳人闻语发娇嗔 禁卫森严夜寂寥 六鳌并驾神仙府 星振珠光铺锦绣 月分金影乱琼瑶
# 词条数量：1271

爱菜词	ai cai ci	1068
爱此花香与月阴	ai ci hua xiang yu yue yin	992
爱他新绿好上我小庭中	ai ta xin lv hao shang wo xiao ting zhong	568
爱晚亭上枫叶愁	ai wan ting shang feng ye chou	1224
爱月迟眠花尚吐	ai yue chi mian hua shang tu	975
安得依书屋开窗碧四围	an de yi shu wu kai chuang bi si wei	576
芭蕉仕女图	ba jiao shi nv tu	524
把酒对月歌	ba jiu dui yue ge	937
拔嶂悬泉隔世嚣层楼曲阁倚云霄	ba zhang xuan quan ge shi xiao ceng lou qu ge yi yun xiao	124
白板门扉红槿篱比邻鹅鸭对妻儿	bai ban men fei hong jin li bi lin e ya dui qi er	1070
白贲谁为偶黄中自保真	bai ben shui wei ou huang zhong zi bao zhen	611
百尺松杉贴地青布衣衲衲发星星	bai chi song shan tie di qing bu yi na na fa xing xing	87
百二关河狼虎秦连环难解献高臣	bai er guan he lang hu qin lian huan nan jie xian gao chen	293
白发衰颓聊遗岁山妻稚子笑颜开	bai fa shuai tui liao yi sui shan qi zhi zi xiao yan kai	262
败荷鹡鸰图	bai he ji ling tu	561
百花绣尽皆鲜巧惟有鸯绣不成鸳	bai hua xiu jin jie xian qiao wei you yang xiu bu cheng yuan	786
百花绣尽皆鲜巧惟有鸳鸯绣不成	bai hua xiu jin jie xian qiao wei you yuan yang xiu bu cheng	1045
白乐天图	bai le tian tu	544
白露蒹葭八月秋征鸿又作稻梁谋	bai lu jian jia ba yue qiu zheng hong you zuo dao liang mou	410
白马曾骑踏海潮由来吴地说前朝	bai ma ceng qi ta hai chao you lai wu de shuo qian chao	1145
百年障眼书千卷四海资身笔一枝	bai nian zhang yan shu qian juan si hai zi shen bi yi zhi	450
白袷檀冠碧玉环倒骑驴子看庐山	bai qia tan guan bi yu huan dao qi lv zi kan lu shan	176
百岁光阴能有几一张假钞没来由	bai sui guang yin neng you ji yi zhang jia chao mei lai you	887
白头也好簪花朵明月难将照酒厄	bai tou ye hao zan hua duo ming yue nan jiang zhao jiu e	1085
白衣人换太元衣浴罢山阴洗研池	bai yi ren huan tai yuan yi yu ba shan yin xi yan chi	489
白缘襕袗碧玉环身于世事玛相关	bai yuan lan zhen bi yu huan shen yu shi shi ma xiang guan	371
白云红树知多少鸡犬人家自一村	bai yun hong shu zhi duo shao ji quan ren jia zi yi cun	84
班荆相对语劳劳麻已沤成茧未缫	ban jing xiang dui yu lao lao ma yi ou cheng jian wei sao	63
办取星冠与霞帔天台明月礼仙真	ban qu xing guan yu xia pei tian tai ming yue li xian zhen	504
半醒半醉日复日花落花开年复年	ban xing ban zui ri fu ri hua luo hua kai nian fu nian	1242
版筑求贤图	ban zhu qiu xian tu	390
半醉驴行缓洞庭黄叶间	ban zui lv xing huan dong ting huang ye jian	215
傍花赏月酒须赊	bang hua shang yue jiu xu she	954
傍水依山结草庐案头长贮活人书	bang shui yi shan jie cao lu an tou chang zhu huo ren shu	185
抱琴归去碧山空一路松声雨鬓风	bao qin gui qu bi shan kong yi lu song sheng yu bin feng	649
抱琴归去图	bao qin gui qu tu	650
饱三餐饭常知足得一帆风便可收	bao san can fan chang zhi zu de yi fan feng bian ke shou	912
北堂草树发新枝堂上莱衣献寿卮	bei tang cao shu fa xin zhi tang shang lai yi xian shou zhi	402
杯邀月影临花醉	bei yao yue ying lin hua zui	989
奔走十年才歇脚偶看画景忽消魂	ben zou shi nian cai xie jiao ou kan hua jing hu xiao hun	78
比当年风景如何	bi dang nian feng jing ru he	434
壁上残灯千里梦月中飞叶四更天	bi shang can deng qian li meng yue zhong fei ye si geng tian	154
碧水涟漪碧藻丛	bi shui lian yi bi zao cong	1233
碧桃花树下大脚墨婆浪	bi tao hua shu xia da jiao mo po lang	1081
便纵拼争反下游随波逐浪讵惭愁	bian zong pin zheng fan xia you sui bo zhu lang ju can chou	24
别人笑我忒疯癫我笑别人看不穿	bie ren xiao wo tei feng dian wo xiao bie ren kan bu chuan	1237
别有诗人好怀抱西风双宾一登台	bie you shi ren hao huai bao xi feng shuang bin yi deng tai	788
别有诗人好怀抱西风双鬓一登台	bie you shi ren hao huai bao xi feng shuang bin yi deng tai	460
鬓边旧白增新白树底深红换浅红	bin bian jiu bai zeng xin bai shu di shen hong huan qian hong	745
冰壶玉斝足追欢还应少个文章侣	bing hu yu jia zu zhui huan hai ying shao ge wen zhang lv	724
冰霜岁聿暮方昭君子心	bing shuang sui yu mu fang zhao jun zi xin	836
冰雪风云事不同今朝尊贵昨朝穷	bing xue feng yun shi bu tong jin zhao zun gui zuo chao qiong	317
伯虎扮乞儿作诗骗酒	bo hu ban qi er zuo shi pian jiu	1176
波弄日光翻上栋	bo nong ri guang fan shang dong	1232
薄幸不来羞睹画梁燕	bo xing bu lai xiu du hua liang yan	698
不才赢得腰堪扎痛对绯桃检药方	bu cai ying de yao kan zha tong dui fei tao jian yao fang	452
不妨唤作水晶宫	bu fang huan zuo shui jing gong	1227
不见倪迂今百年故山乔木领苍烟	bu jian ni yu jin bai nian gu shan qiao mu ling cang yan	508
不见五陵豪杰墓无花无酒锄做田	bu jian wu ling hao jie mu wu hua wu jiu chu zuo tian	1236
不教轻踏莲花去谁识仙娥玩世来	bu jiao qing ta lian hua qu shui shi xian e wan shi lai	265
不炼金丹不坐禅	bu lian jin dan bu zuo chan	1220
不炼金丹不坐禅饥来吃饭倦来眠	bu lian jin dan bu zuo chan ji lai chi fan juan lai mian	905
不起竹床头似雪已无心去问襌机	bu qi zhu chuang tou si xue yi wu xin qu wen chan ji	60
不如芦花水清浅波涛不作无怨心	bu ru lu hua shui qing qian bo tao bu zuo wu yuan xin	858
不如平原采短薪无虑无忧更无辱	bu ru ping yuan cai duan xin wu lv wu you geng wu ru	860
不烧高烛照芳樽也是虚生在人世	bu shao gao zhu zhao fang zun ye shi xu sheng zai ren shi	732
不使人间造孽钱	bu shi ren jian zao nie qian	1217
不为商贾不耕田	bu wei shang gu bu geng tian	1219
不信死花胜活人	bu xin si hua sheng huo ren	1263
不因送客东城去过却春光总不知	bu yin song ke dong cheng qu guo que chun guang zong bu zhi	139
不知施药功多少仙杏花开锦不如	bu zhi shi yao gong duo shao xian xing hua kai jin bu ru	184
不醉歌毋返无强共所祈	bu zui ge wu fan wu qiang gong suo qi	347
采药知何处柴门掩白云	cai yao zhi he chu chai men yan bai yun	581
菜之味兮不可轻人无此味将何行	cai zhi wei xi bu ke qing ren wu ci wei jiang he xing	1067
才作花宾又月宾	cai zuo hua bin you yue bin	1006
灿灿花前月一轮	can can hua qian yue yi lun	1022
残春鞋袜试东郭绿池横浸红桥影	can chun xie wa shi dong guo lv chi heng jin hong qiao ying	715
残粉黄生银扑面故衣香寄玉关胸	can fen huang sheng yin pu mian gu yi xiang ji yu guan xiong	1141
残睡无多有滋味中年到底没心情	can shui wu duo you zi wei zhong nian dao di mei xin qing	890
苍江寒更急客发自中流	cang jiang han geng ji ke fa zi zhong liu	211
草阁吟秋倚晚晴云山满目夕阳明	cao ge yin qiu yi wan qing yun shan man mu xi yang ming	138
草里高低多少坟一年一半无人扫	cao li gao di duo shao fen yi nian yi ban wu ren sao	920
草庐三顾屈英雄慷慨南阳起卧龙	cao lu san gu qu ying xiong kang kai nan yang qi wo long	475
草青经宿雨山紫带斜曛	cao qing jing su yu shan zi dai xie xun	582
草苫书斋石垒塘栏杆委曲娆溪傍	cao shan shu zhai shi lei tang lan gan wei qu rao xi bang	311
草堂话旧图	cao tang hua jiu tu	641
草屋柴门无点尘门前溪水绿粼粼	cao wu chai men wu dian chen men qian xi shui lv lin lin	67
曾见趋炎堪炙手宁抛伫艳敢成仁	ceng jian qu yan kan zhi shou ning pao zhu yan gan cheng ren	39
钗垂宝髻甚娇羞花雪飞散青霄里	chai chui bao ji shen jiao xiu hua xue fei san qing xiao li	616
柴门深闭蓣徐煨沽得邻家村酿来	chai men shen bi yu xu wei gu de lin jia cun niang lai	263
柴门深掩雪洋洋榾柮能清此夜长	chai men shen yan xue yang yang gu duo neng qing ci ye chang	49
柴米油盐酱醋茶般般都在别人家	chai mi you yan jiang cu cha ban ban dou zai bie ren jia	339
铲却筌蹄窥远奥拈花莞尔有何愁	chan que quan ti kui yuan ao nian hua wan er you he chou	33
长剑倚天磨十载东君为我且重开	chang jian yi tian mo shi zai dong jun wei wo qie chong kai	29
长空影动花迎月	chang kong ying dong hua ying yue	973
阊门即事	chang men ji shi	1193
长松百尺荫清溪倒影波间势转低	chang song bai chi yin qing xi dao ying bo jian shi zhuan di	652
长松落阴满苍苔四面轩窗向水开	chang song luo yin man cang tai si mian xuan chuang xiang shui kai	45
长夏山村诗兴幽趁淡多在碧泉头	chang xia shan cun shi xing you chen dan duo zai bi quan tou	93
常向静中参大道不因忙里庆清呤	chang xiang jing zhong can da dao bu yin mang li qing qing ling	853
车尘马足富者趣酒盏花枝贫者缘	che chen ma zu fu zhe qu jiu zhan hua zhi pin zhe yuan	1240
尘埃不到市朝远琴趣年来只自知	chen ai bu dao shi chao yuan qin qu nian lai zhi zi zhi	125
尘泥养份残骸纳香影知音惰性空	chen ni yang fen can hai na xiang ying zhi yin duo xing kong	6
沉醉欲眠花月下	chen zui yu mian hua yue xia	979
城上将军原有令江南才子本无知	cheng shang jiang jun yuan you ling jiang nan cai zi ben wu zhi	443
迟归	chi gui	446
池面风回公簇聚陌场人散鞠场休	chi mian feng hui gong cu ju mo chang ren san ju chang xiu	761
池塘春涨碧溶溶醉卧香尘浅草中	chi tang chun zhang bi rong rong zui wo xiang chen qian cao zhong	287
愁杀花间问月人	chou sha hua jian wen yue ren	1018
厨中有碗黄齑粥三生自有清闲福	chu zhong you wan huang ji zhou san sheng zi you qing xian fu	1062
窗含烟景直浮空	chuang han yan jing zhi fu kong	1231
窗满蕉荫小洞天香风时度竹栏边	chuang man jiao yin xiao dong tian xiang feng shi du zhu lan bian	256
窗榻类画舫山水清且嘉	chuang ta lei hua fang shan shui qing qie jia	1155
垂虹别意图	chui hong bie yi tu	800
垂虹不是坝陵桥送客能来路亦遥	chui hong bu shi ba ling qiao song ke neng lai lu yi yao	799
春归不得驻须臾恙落宁知剩有无	chun gui bu de zhu xu yu yang luo ning zhi sheng you wu	754
春花秋月两相宜	chun hua qiu yue liang xiang yi	945
春尽愁中与病中花枝遭雨又遭风	chun jin chou zhong yu bing zhong hua zhi zao yu you zao feng	746
春困无端压黛眉梳成松鬓出帘迟	chun kun wu duan ya dai mei shu cheng song bin chu lian chi	274
春林通一径野色此中分	chun lin tong yi jing ye se ci zhong fen	584
春驴仙客到诗家为赏临溪好杏花	chun lv xian ke dao shi jia wei shang lin xi hao xing hua	95
春日客途悲白发给园兵燹废黄金	chun ri ke tu bei bai fa gei yuan bing xian fei huang jin	1119
春三秋九号温和天气温和风雨多	chun san qiu jiu hao wen he tian qi wen he feng yu duo	735
春色关心万种情酒杯聊寞可怜生	chun se guan xin wan zhong qing jiu bei liao mo ke lian sheng	540
春色后先君莫讶后头花更得春多	chun se hou xian jun mo ya hou tou hua geng dei chun duo	245
春色撩人不自由野花满地不忘忧	chun se liao ren bu zi you ye hua man di bu wang you	244
春山伴侣两三人担酒寻花不厌频	chun shan ban lv liang san ren dan jiu xun hua bu yan pin	658
春山伴侣图	chun shan ban lv tu	659
春夏秋冬捻指间钟送黄昏鸡报晓	chun xia qiu dong nian zhi jian zhong song huang hun ji bao xiao	922
春宵花月值千金	chun xiao hua yue zhi qian jin	993
春宵一刻千金价我道千金买不回	chun xiao yi ke qian jin jia wo dao qian jin mai bu hui	730
春心自是应难制做出风流滋味长	chun xin zi shi ying nan zhi zuo chu feng liu zi wei chang	249
椿萱图	chun xuan tu	512
春游女几山图	chun you nv ji shan tu	683
此际栏杆能独倚分明身是试登瀛	ci ji lan gan neng du yi fen ming shen shi shi deng ying	660
此景凭谁拟何处金阊亭下暮烟中	ci jing ping shui ni he chu jin chang ting xia mu yan zhong	423
此君少与契忘形何独相延厌客星	ci jun shao yu qi wang xing he du xiang yan yan ke xing	807
慈鸟鸣鸣闹晓林羽毛单薄雪霜深	ci niao ming ming nao xiao lin yu mao dan bo xue shuang shen	380
此身陷入酽寒中血脉归心迓谷风	ci shen xian ru yan han zhong xue mai gui xin ya gu feng	8
此生甘兮走昊阊辱皆无剩有狂句	ci sheng gan xi zou hao chang ru jie wu sheng you kuang ju	451
此行倘有重来便须折琅玕一朵花	ci xing tang you chong lai bian xu zhe lang gan yi duo hua	1091
此中大有逍遥处难说与君画与君	ci zhong da you xiao yao chu nan shuo yu jun hua yu jun	146
此中意恐无人会更向其间赋小诗	ci zhong yi kong wu ren hui geng xiang qi jian fu xiao shi	604
从来不食溪边草自古难耕陇上田	cong lai bu shi xi bian cao zi gu nan geng long shang tian	1115
促席坐鸣琴写我平生心	cu xi zuo ming qin xie wo ping sheng xin	207
崔徽自写镜中真洛水谁传赋里神	cui hui zi xie jing zhong zhen luo shui shui chuan fu li shen	742
翠袖三千楼上下黄金百万水西东	cui xiu san qian lou shang xia huang jin bai wan shui xi dong	1191
翠竹并奇石苍松留古柯	cui zhu bing qi shi cang song liu gu ke	574
嵯峨怪石倚云间抛掷于今定几年	cuo e guai shi yi yun jian pao zhi yu jin ding ji nian	1117
大江之东水为国其间巨浸称震泽	da jiang zhi dong shui wei guo qi jian ju jin cheng zhen ze	333
大老兼尊德吾将同所归	da lao jian zun de wu jiang tong suo gui	343
大明门外朝天客立马先听第一声	da ming men wai chao tian ke li ma xian ting di yi sheng	1180
大衾长枕共春秋斗鸡走狗连朝夕	da qin chang zhen gong chun qiu dou ji zou gou lian zhao xi	601
大雪寻梅好写诗隔江友家泛金扈	da xue xun mei hao xie shi ge jiang you jia fan jin hu	445
大叶偏鸣雨芳心又展风	da ye pian ming yu fang xin you zhan feng	569
待看月落花残夜	dai kan yue luo hua can ye	1019
带月看花别样姿	dai yue kan hua bie yang zi	996
但恨今人不如古高歌伐木矢沧浪	dan hen jin ren bu ru gu gao ge fa mu shi cang lang	878
箪瓢不厌久沉伦投着虚怀好主人	dan piao bu yan jiu chen lun tou zhe xu huai hao zhu ren	809
丹砂岂是千年药白日难消两鬓霜	dan sha qi shi qian nian yao bai ri nan xiao liang bin shuang	909
淡雾滃山腰清风集树梢	dan wu weng shan yao qing feng ji shu shao	214
但愿老死花酒间不愿鞠躬车马前	dan yuan lao si hua jiu jian bu yuan ju gong che ma qian	1241
但愿人人知此味此味安能别苍生	dan yuan ren ren zhi ci wei ci wei an neng bie cang sheng	1064
当年到此曾携手寒色今犹满布袍	dang nian dao ci ceng xie shou han se jin you man bu pao	112
当年孔圣今何在昔日萧曹尽已休	dang nian kong sheng jin he zai xi ri xiao cao jin yi xiu	886
当时藩镇在谋逆谋以如公不易得	dang shi fan zhen zai mou ni mou yi ru gong bu yi de	591
当时我作陶承旨何必尊前面发红	dang shi wo zuo tao cheng zhi he bi zun qian mian fa hong	1059
当时我作陶承旨何必樽前面发红	dang shi wo zuo tao cheng zhi he bi zun qian mian fa hong	619
谠言不用时事危忠臣志士最堪悲	dang yan bu yong shi shi wei zhong chen zhi shi zui kan bei	589
到老杨枝亦辞去张娟林态竟如何	dao lao yang zhi yi ci qu zhang juan lin tai jing ru he	542
得一日闲无量福作千年调笑人痴	de yi ri xian wu liang fu zuo qian nian tiao xiao ren chi	1084
登山	deng shan	891
灯山忽见翠召荛	deng shan hu jian cui zhao rao	1258
邓尉山边七宝滩高低如画好溪山	deng wei shan bian qi bao tan gao di ru hua hao xi shan	83
低头照井脱纱巾惊看白发已如尘	di tou zhao jing tuo sha jin jing kan bai fa yi ru chen	713
地宅方圆人不在儿孙长大我难留	di zhai fang yuan ren bu zai er sun zhang da wo nan liu	916
点检鸡栖牛缚草夜来有虎饮山泉	dian jian ji qi niu fu cao ye lai you hu yin shan quan	545
鼎足未安星又陨阵图留与浪涛春	ding zu wei an xing you yun zhen tu liu yu lang tao chun	474
洞宾花女人携瓶图	dong bin hua nv ren xie ping tu	553
洞宾图	dong bin tu	297
东方朔图	dong fang shuo tu	632
东风吹动看梅期箫鼓联船发恐迟	dong feng chui dong kan mei qi xiao gu lian chuan fa kong chi	784
冬寒夏热最叹当寒则如刀热如炙	dong han xia re zui tan dang han ze ru dao re ru zhi	736
东君管领春无价笑倩金蓬上玉肩	dong jun guan ling chun wu jia xiao qian jin peng shang yu jian	255
栋梁本色擎天柱蝥贼原形钓欲	dong liang ben shai qing tian zhu mao zei yuan xing diao yu	34
东林寺前三峡桥山泉汹涌水波涛	dong lin si qian san xia qiao shan quan xiong yong shui bo tao	113
东坡小像	dong po xiao xiang	242
洞山图卷	dong shan tu juan	470
洞庭有奇士楼室栖云霞	dong ting you qi shi lou shi qi yun xia	1156
东涂西抹出天涯管领烟霞主风月	dong tu xi mo chu tian ya guan ling yan xia zhu feng yue	362
东西茅屋鸡豚社气象粗疏有古心	dong xi mao wu ji tun she qi xiang cu shu you gu xin	177
东崦荷花西崦菱大船渔网小船罨	dong yan he hua xi yan ling da chuan yu wang xiao chuan yan	182
东庄图	dong zhuang tu	532
妒花	du hua	1271
独立溪头穷物理不知斜日落平川	du li xi tou qiong wu li bu zhi xie ri luo ping chuan	406
独怜节操非凡种曾向陶君径里来	du lian jie cao fei fan zhong ceng xiang tao jun jing li lai	493
独木桥边倚树根古藤阴里啸王孙	du mu qiao bian yi shu gen gu teng yin li xiao wang sun	85
杜牧图	du mu tu	315
读书比比不出户柴门流水声潺湲	du shu bi bi bu chu hu chai men liu shui sheng chan yuan	360
独有牧童牛背隐归来一笠带沦	du you mu tong niu bei yin gui lai yi li dai lun	654
独有汝阳知律吕曾把流离陈明主	du you ru yang zhi lv lv ceng ba liu li chen ming zhu	596
短墙甃石牢牵荔薄酒盈坛共转筒	duan qiang zhou shi lao qian li bo jiu ying tan gong zhuan tong	320
端阳竟渡楚江湄纨裤分曹唱健词	duan yang jing du chu jiang mei wan ku fen cao chang jian ci	71
对菊图	dui ju tu	205
对月看花有所思	dui yue kan hua you suo si	984
对竹图	dui zhu tu	810
踱步鞋痕师禀气居身境界辟新蹊	duo bu xie hen shi bing qi ju shen jing jie pi xin xi	18
多情为惜郎君力暂借风流占上头	duo qing wei xi lang jun li zan jie feng liu zhan shang tou	243
多情犹恐春云坠捱枕扶头倩小姬	duo qing you kong chun yun zhui ai zhen fu tou qian xiao ji	251
多情月照花间露	duo qing yue zhao hua jian lu	1015
多少好花空落尽不曾遇着赏花人	duo shao hao hua kong luo jin bu ceng yu zhe shang hua ren	775
多少花前月下客	duo shao hua qian yue xia ke	995
恩变作仇顿忘了神前咒	en bian zuo chou dun wang le shen qian zhou	439
恩仇	en chou	441
恩多成怨悔只悔当初不识风流面	en duo cheng yuan hui zhi hui dang chu bu shi feng liu mian	440
恩情只在牙床上闲剎香闺两绣墩	en qing zhi zai ya chuang shang xian cha xiang gui liang xiu dun	253
方床石枕眠清画荷叶荷花互送香	fang chuang shi zhen mian qing hua he ye he hua hu song xiang	310
仿佛希夷亲面目大还真诀得亲传	fang fu xi yi qin mian mu da hai zhen jue de qin chuan	376
芳园秋色似春时红紫纷菲映绿池	fang yuan qiu se si chun shi hong zi fen fei ying lv chi	399
飞唤行摇类急难野田寒露欲成团	fei huan xing yao lei ji nan ye tian han lu yu cheng tuan	560
费尽工夫伤老大不如抖擞作新人	fei jin gong fu shang lao da bu ru dou sou zuo xin ren	37
飞雪蔽空无鸟迹长山颠壑有人居	fei xue bi kong wu niao ji chang shan dian he you ren ju	161
粉粉花事成无赖默默春心怨欲私	fen fen hua shi cheng wu lai mo mo chun xin yuan yu si	749
分明蛮锦围屏里露出佳人粉面来	fen ming man jin wei ping li lou chu jia ren fen mian lai	68
分明苕霅溪头路何日归家买木兰	fen ming shao zha xi tou lu he ri gui jia mai mu lan	141
纷簌簌然丛脞弃脏兮兮地秽淫流	fen su su ran cong cuo qi zang xi xi di hui yin liu	35
焚香对坐浑无事自与诗书结静缘	fen xiang dui zuo hun wu shi zi yu shi shu jie jing yuan	170
风动花枝探月影	feng dong hua zhi tan yue ying	951
讽炼金方士	feng lian jin fang shi	1055
凤鸟自歌鸾自舞直教衔到寿尊前	feng niao zi ge luan zi wu zhi jiao xian dao shou zun qian	556
风暖香消翠帐柔相逢偏喜得春稠	feng nuan xiang xiao cui zhang rou xiang feng pian xi de chun chou	258
峰前千涧玉潺潺落日层层树里山	feng qian qian jian yu chan chan luo ri ceng ceng shu li shan	165
风情抵老如潘朗颠倒骑驴过华山	feng qing di lao ru pan lang dian dao qi lv guo hua shan	370
凤头交股雪花镔剪断吴淞江水浑	feng tou jiao gu xue hua bin jian duan wu song jiang shui hun	1040
佛说空虚也可量虚空比恨恨还长	fo shuo kong xu ye ke liang xu kong bi hen hen hai chang	1043
佛友	fo you	43
富贵荣华莫强求强求不出反成羞	fu gui rong hua mo qiang qiu qiang qiu bu chu fan cheng xiu	918
夫椒山人耿敬霁与我十年为旧识	fu jiao shan ren geng jing ji yu wo shi nian wei jiu shi	331
扶筇散步碧山游万壑千岩爽气浮	fu qiong san bu bi shan you wan he qian yan shuang qi fu	47
扶笻月下寻花步	fu qiong yue xia xun hua bu	965
浮生聚散是浮萍何须日夜苦蝇营	fu sheng ju san shi fu ping he xu ri ye ku ying ying	709
俯首流泉仰听风泉声风韵合笙镛	fu shou liu quan yang ting feng quan sheng feng yun he sheng yong	643
拂曙起来人不解只缘难放惜花心	fu shu qi lai ren bu jie zhi yuan nan fang xi hua xin	231
扶头酒醒宝香焚戏写蒲东一片云	fu tou jiu xing bao xiang fen xi xie pu dong yi pian yun	383
感怀	gan huai	906
感君称我为奇士又言天下无相似	gan jun cheng wo wei qi shi you yan tian xia wu xiang si	877
高山奇树似城南兀坐联诗兴不厌	gao shan qi shu si cheng nan wu zuo lian shi xing bu yan	673
高山奇树图	gao shan qi shu tu	674
高台明月照花枝	gao tai ming yue zhao hua zhi	985
高台平落骛清磬起潸螭	gao tai ping luo wu qing qing qi shan chi	828
膏腴望望应千顷黄地黄金下夕阳	gao yu wang wang ying qian qing huang di huang jin xia xi yang	530
高祖斩蛇图	gao zu zhan she tu	479
咯咯笑声郎仰面竹林深处唤小名	ge ge xiao sheng lang yang mian zhu lin shen chu huan xiao ming	421
隔花窥月无多影	ge hua kui yue wu duo ying	997
隔继往来南北雁只容日月过东西	ge ji wang lai nan bei yan zhi rong ri yue guo dong xi	1125
蛤蜊上市惊新味鹈鴃催人在洗杯	ge li shang shi jing xin wei ti jue cui ren zai xi bei	769
隔帘栊鸟声隔帘栊鸟声把人惊觉	ge lian long niao sheng ge lian long niao sheng ba ren jing jue	707
戈文雪景图	ge wen xue jing tu	264
葛仙图	ge xian tu	280
更欲传杯迟判袂月明倚柱唤吹箫	geng yu chuan bei chi pan mei yue ming yi zhu huan chui xiao	796
宫妃夜游图	gong fei ye you tu	618
宫声不属商声暴琵声起少琶声多	gong sheng bu shu shang sheng bao pi sheng qi shao pa sheng duo	597
狗监犹能荐才子当时宰相是闲人	gou jian you neng jian cai zi dang shi zai xiang shi xian ren	471
古春去也怅须臾问尔能思几日无	gu chun qu ye chang xu yu wen er neng si ji ri wu	16
孤芳自赏雕虫老兴尽尘封故纸楼	gu fang zi shang diao chong lao xing jin chen feng gu zhi lou	21
鼓腹年年歌帝力不须祈谷幸操壶	gu fu nian nian ge di li bu xu qi gu xing cao hu	222
古今才一瞬问江上才人阁中帝子	gu jin cai yi shun wen jiang shang cai ren ge zhong di zi	435
古今代谢歌新韵辩证思维好坏携	gu jin dai xie ge xin yun bian zheng si wei hao huai xie	17
古句磨崖留岁月读之漫灭为修容	gu ju mo ya liu sui yue du zhi man mie wei xiu rong	867
古来花貌说仙娥自是仙娥薄命多	gu lai hua mao shuo xian e zi shi xian e bo ming duo	238
古人行处青苔冷馆娃官锁西施井	gu ren xing chu qing tai leng guan wa guan suo xi shi jing	714
古人有这达矣哉劝人秉烛夜游来	gu ren you zhe da yi zai quan ren bing zhu ye you lai	731
顾身已自登缑岭	gu shen yi zi deng gou ling	1253
故事开元重牡丹沉香亭北冷泉南	gu shi kai yuan zhong mu dan chen xiang ting bei leng quan nan	405
姑苏城外一茅屋万树桃花月满天	gu su cheng wai yi mao wu wan shu tao hua yue man tian	929
谷雨花枝号鼠姑戏拈彤管画成图	gu yu hua zhi hao shu gu xi nian tong guan hua cheng tu	537
孤竹图	gu zhu tu	369
观鳌山	guan ao shan	1260
官大钱多心转忧落得自家头白早	guan da qian duo xin zhuan you luo de zi jia tou bai zao	923
灌木寒声集丛筱静色深	guan mu han sheng ji cong xiao jing se shen	837
观瀑图	guan pu tu	464
惯随忧恨零今古难惹英雄泣鬼神	guan sui you hen ling jin gu nan re ying xiong qi gui shen	38
桂月花传郢北词	gui yue hua chuan ying bei ci	940
海棠美人图	hai tang mei ren tu	236
海棠庭院又春深一寸光阴万两金	hai tang ting yuan you chun shen yi cun guang yin wan liang jin	232
海棠枝上白头公头映花枝转觉红	hai tang zhi shang bai tou gong tou ying hua zhi zhuan jue hong	386
函关雪霁旅人稠轻载驴骡重载牛	han guan xue ji lv ren chou qing zai lv luo chong zai niu	688
函关雪霁图	han guan xue ji tu	689
汉皇故人钓鱼矶渔矶犹昔世人非	han huang gu ren diao yu ji yu ji you xi shi ren fei	825
寒溜浸幽壑危亭点翠微	han liu jin you he wei ting dian cui wei	194
寒雀争松图	han que zheng song tu	564
寒香与晚色消受掌中杯	han xiang yu wan se xiao shou zhang zhong bei	209
寒雪朝来战朔风万山开遍玉芙蓉	han xue chao lai zhan shuo feng wan shan kai bian yu fu rong	679
浩浩天地知谁坐酌酒敌寒犹读书	hao hao tian di zhi shui zuo zhuo jiu di han you du shu	160
好花好月知多少	hao hua hao yue zhi duo shao	1003
好花难种不长开少年易过不重来	hao hua nan zhong bu chang kai shao nian yi guo bu chong lai	1195
好是泉头池上石软莎堪坐静无尘	hao shi quan tou chi shang shi ruan sha kan zuo jing wu chen	657
何必秦姬奏洞箫	he bi qin ji zou dong xiao	1252
何必伤心催发白会当动手补颜朱	he bi shang xin cui fa bai hui dang dong shou bu yan zhu	15
合村会议无他事定是人来借花时	he cun hui yi wu ta shi ding shi ren lai jie hua shi	607
荷花仙子图	he hua xian zi tu	267
鹤迹松阴见泉声竹里闻	he ji song yin jian quan sheng zhu li wen	583
和靖图	he jing tu	482
和沈石田落花诗	he shen shi tian luo hua shi	901
何事世人皆不识尚留余与人猜	he shi shi ren jie bu shi shang liu yu yu ren cai	551
何事夜深还演艺花前争奈月明何	he shi ye shen hai yan yi hua qian zheng nai yue ming he	268
何事幽人常独立只缘诗意满胸中	he shi you ren chang du li zhi yuan shi yi man xiong zhong	693
何限晚凉消不得隔溪分看待人来	he xian wan liang xiao bu de ge xi fen kan dai ren lai	44
何以结欢爱渠碗出于阗	he yi jie huan ai qu wan chu yu tian	844
荷衣凉透忍不得寒郊瘦岛谁争强	he yi liang tou ren bu de han jiao shou dao shui zheng qiang	356
恨杀牧童鞭不起笛声斜挂夕阳烟	hen sha mu tong bian bu qi di sheng xie gua xi yang yan	1114
红拂妓图	hong fu ji tu	291
红莲锦袖曹刚手珑板腰肢捉板歌	hong lian jin xiu cao gang shou long ban yao zhi zhuo ban ge	269
红绫敢望明年饼黄绢深惭此日书	hong ling gan wang ming nian bing huang juan shen can ci ri shu	1159
红树黄茅野老家日高山犬吠篱笆	hong shu huang mao ye lao jia ri gao shan quan fei li ba	608
红树青山飞白云骖驔鞍马踏斜曛	hong shu qing shan fei bai yun can dian an ma ta xie xun	75
红树中间飞白云黄茅眼底界斜曛	hong shu zhong jian fei bai yun huang mao yan di jie xie xun	147
红霞潋滟碧波平晴色湖光尽不成	hong xia lian yan bi bo ping qing se hu guang jin bu cheng	661
红杏梢头挂酒旗绿杨枝上转黄骊	hong xing shao tou gua jiu qi lv yang zhi shang zhuan huang li	514
红颜光蜕三生骨紫陌香消一丈尘	hong yan guang tui san sheng gu zi mo xiang xiao yi zhang chen	740
后改	hou gai	1104
忽惊双鹤泪有客款荆扉	hu jing shuang he lei you ke kuan jing fei	193
忽然一日来相逢满头短发皆蓬松	hu ran yi ri lai xiang feng man tou duan fa jie peng song	863
湖上水田人不要谁来买我画中山	hu shang shui tian ren bu yao shui lai mai wo hua zhong shan	1075
湖上桃花坞扁舟信往还	hu shang tao hua wu pian zhou xin wang huan	676
呼它小艇过湖去卧看斜阳江上峰	hu ta xiao ting guo hu qu wo kan xie yang jiang shang feng	58
呼童摘取菖蒲叶验到秋来白露团	hu tong zhai qu chang pu ye yan dao qiu lai bai lu tuan	791
湖州得娟俱充袜我把轻缣试高揭	hu zhou de juan ju chong wa wo ba qing jian shi gao jie	363
花残还有月催诗	hua can hai you yue cui shi	998
画成此景还堪咏炼在先生短句中	hua cheng ci jing hai kan yong lian zai xian sheng duan ju zhong	179
画栋珠帘烟水中落霞孤骛渺无踪	hua dong zhu lian yan shui zhong luo xia gu wu miao wu zong	1089
花萼楼前夜开燕沉水凝烟灯吐焰	hua e lou qian ye kai yan chen shui ning yan deng tu yan	600
花发千枝月一轮	hua fa qian zhi yue yi lun	1009
花发月中香满树	hua fa yue zhong xiang man shu	943
画楫万枝飞鹢道朱帘十二映娥眉	hua ji wan zhi fei yi dao zhu lian shi er ying e mei	70
花间多少月精神	hua jian duo shao yue jing shen	1020
花降图	hua jiang tu	259
花开不知人已去年年斗绿与争绯	hua kai bu zhi ren yi qu nian nian dou lv yu zheng fei	645
花开烂漫月光华	hua kai lan man yue guang hua	961
花美似人临月镜	hua mei si ren lin yue jing	967
画盆石菖蒲	hua pen shi chang pu	795
花气芬芳月正饶	hua qi fen fang yue zheng rao	952
花前月不厌人贫	hua qian yue bu yan ren pin	1004
花前月下得高歌急需满把金樽倒	hua qian yue xia de gao ge ji xu man ba jin zun dao	925
花却何情月何意	hua que he qing yue he yi	939
花如罗绮月如银	hua ru luo qi yue ru yin	1024
华山图	hua shan tu	372
画堂基构画船通	hua tang ji gou hua chuan tong	1234
花溪渔隐图	hua xi yu yin tu	677
花下轻传弄月箫	hua xia qing chuan nong yue xiao	948
花下酌酒歌	hua xia zhuo jiu ge	1198
花香月色两相宜	hua xiang yue se liang xiang yi	1001
花羞月色夜沉沉	hua xiu yue se ye chen chen	990
华筵盛宾从诞节好春晖	hua yan sheng bin cong dan jie hao chun hui	348
花因随月上窗纱	hua yin sui yue shang chuang sha	958
花迎月魄若为容	hua ying yue po ruo wei rong	1016
花月世间成二美	hua yue shi jian cheng er mei	955
花月吟效连珠体十一首	hua yue yin xiao lian zhu ti shi yi shou	1026
花正开时月正明	hua zheng kai shi yue zheng ming	1025
画烛留锡市酸风飐酒旗	hua zhu liu xi shi suan feng zhan jiu qi	228
花自芳菲月自华	hua zi fang fei yue zi hua	976
淮海修真遗丽华它言道是我言差	huai hai xiu zhen yi li hua ta yan dao shi wo yan cha	299
怀贤欲鼓猗兰操有客携琴过小桥	huai xian yu gu yi lan cao you ke xie qin guo xiao qiao	669
荒村风雨杂鸡鸣轑釜朝厨愧老妻	huang cun feng yu za ji ming lao fu chao chu kui lao qi	1074
黄花无主为谁容冷落疏篱曲径中	huang hua wu zhu wei shui rong leng luo shu li qu jing zhong	1134
皇天老早安排定不用忧煎不用愁	huang tian lao zao an pai ding bu yong you jian bu yong chou	915
晃漾金银帆殿开萧森杉柳隔纷埃	huang yang jin yin fan dian kai xiao sen shan liu ge fen ai	117
黄叶玲珑映落晖木绵新补旧征衣	huang ye ling long ying luo hui mu mian xin bu jiu zheng yi	65
黄叶没鞋人不到豆篱花发浸溪红	huang ye mei xie ren bu dao dou li hua fa jin xi hong	97
黄叶山家绕会琴斜阳流水路阴阴	huang ye shan jia rao hui qin xie yang liu shui lu yin yin	178
黄衣冠子翠云裘四海三山挟弹游	huang yi guan zi cui yun qiu si hai san shan xie dan you	296
或为月主为花主	huo wei yue zhu wei hua zhu	1007
记得昔年曾识面桃花深处短墙头	ji de xi nian ceng shi mian tao hua shen chu duan qiang tou	728
几回缺月还圆月数阵南风又北风	ji hui que yue hai yuan yue shu zhen nan feng you bei feng	1205
寂寞浔阳白司马青袗掩骭官僚下	ji mo xun yang bai si ma qing zhen yan gan guan liao xia	593
积善坊中五王宅重楼复阁辉金碧	ji shan fang zhong wu wang zhai chong lou fu ge hui jin bi	602
急须沽酒浇清冻亦有疏梅唤客看	ji xu gu jiu jiao qing dong yi you shu mei huan ke kan	50
技知此味艺业精商知此味货利增	ji zhi ci wei yi ye jing shang zhi ci wei huo li zeng	1065
家居东南云锦乡心魂原是水花香	jia ju dong nan yun jin xiang xin hun yuan shi shui hua xiang	419
佳人插花图	jia ren cha hua tu	275
佳人春睡倚含章一瓣梅花点额黄	jia ren chun shui yi han zhang yi ban mei hua dian e huang	521
佳人对月图	jia ren dui yue tu	278
佳人见语发娇嗔不信死花胜活人	jia ren jian yu fa jiao chen bu xin si hua sheng huo ren	1097
佳人名字号经莲能事挡弹五十弦	jia ren ming zi hao jing lian neng shi dang dan wu shi xian	519
佳人停板图	jia ren ting ban tu	272
佳人闻语发娇嗔	jia ren wen yu fa jiao chen	1264
佳人晓起出兰房	jia ren xiao qi chu lan fang	1268
佳人晓起出兰房折来对镜比红妆	jia ren xiao qi chu lan fang zhe lai dui jing bi hong zhuang	1099
佳色含霜向日开余香冉冉覆莓苔	jia se han shuang xiang ri kai yu xiang ran ran fu mei tai	494
剑贵百金方折阅玉遭三黜忽沽诸	jian gui bai jin fang zhe yue yu zao san chu hu gu zhu	1160
剑佩丁年朝帝扆星晨午夜拂仙槎	jian pei ding nian chao di yi xing chen wu ye fu xian cha	1093
涧上清吟图	jian shang qing yin tu	351
涧水浮花出松云伴鹤飞	jian shui fu hua chu song yun ban he fei	578
剑责百金方折阅玉遭三黜忽沽诸	jian ze bai jin fang zhe yue yu zao san chu hu gu zhu	873
将花揉碎掷郎前	jiang hua rou sui zhi lang qian	1262
将花揉碎掷郎前请郎今夜伴花眠	jiang hua rou sui zhi lang qian qing lang jin ye ban hua mian	1096
江南春尽野花稀绿树阴阴结夏帏	jiang nan chun jin ye hua xi lv shu yin yin jie xia wei	136
江南春色莺花老又汲新泉浸芰荷	jiang nan chun se ying hua lao you ji xin quan jin ji he	246
江南农事图	jiang nan nong shi tu	467
江南行	jiang nan xing	717
江上春风吹嫩榆扶琴送子曳长裙	jiang shang chun feng chui nen yu fu qin song zi ye chang qun	691
江上乌帽谁渡水岩际白衣人采松	jiang shang wu mao shui du shui yan ji bai yi ren cai song	868
胶粘日月无长策酒对荼蘼有近忧	jiao zhan ri yue wu chang ce jiu dui tu mi you jin you	760
解笔淋漓写竹枝分明风雨满天时	jie bi lin li xie zhu zhi fen ming feng yu man tian shi	605
嶰谷失黄钟大雅变正音	jie gu shi huang zhong da ya bian zheng yin	834
借问牧童应没酒试尝松子又生仁	jie wen mu tong ying mei jiu shi chang song zi you sheng ren	777
节序推移比弹指铅华狼籍又辞春	jie xu tui yi bi tan zhi qian hua lang ji you ci chun	741
解语花摇月下风	jie yu hua yao yue xia feng	1014
嗟余漂泊随饘粥渺渺江湖何所归	jie yu piao bo sui zhan zhou miao miao jiang hu he suo gui	822
尽把金钱买脂粉一生颜色付西风	jin ba jin qian mai zhi fen yi sheng yan se fu xi feng	1133
金阊暮烟图	jin chang mu yan tu	425
金阊送别图	jin chang song bie tu	417
金阊杨柳麦尘丝又送吾儿上路岐	jin chang yang liu mai chen si you song wu er shang lu qi	416
金丹不了红颜别地下相逢两面沙	jin dan bu liao hong yan bie di xia xiang feng liang mian sha	298
槿花易衰歇桂枝就销亡	jin hua yi shuai xie gui zhi jiu xiao wang	1171
锦开花里幛彩戏膝前衣	jin kai hua li zhang cai xi xi qian yi	344
锦里先生日晏眠客来高论坐无毡	jin li xian sheng ri yan mian ke lai gao lun zuo wu zhan	396
金缕歌中无所悔青蚨尾后有些私	jin lv ge zhong wu suo hui qing fu wei hou you xie si	11
今人犹歌李白诗明月还如李白时	jin ren you ge li bai shi ming yue hai ru li bai shi	934
今日酒杯歌袖畔竟忘门外到长安	jin ri jiu bei ge xiu pan jing wang men wai dao chang an	636
今日匡床卧摩诘白藤如意紫纶巾	jin ri kuang chuang wo mo jie bai teng ru yi zi guan jin	101
尽胜达官忧利害五更霜里佩黄金	jin sheng da guan you li hai wu geng shuang li pei huang jin	88
锦丝步帐繁花里闲弄珊瑚血色枝	jin si bu zhang fan hua li xian nong shan hu xue se zhi	525
禁卫森严夜寂寥	jin wei sen yan ye ji liao	1259
今夜月圆花好处	jin ye yue yuan hua hao chu	983
今朝春比昨朝春南阮番成北阮贫	jin zhao chun bi zuo chao chun nan ruan fan cheng bei ruan pin	778
镜里形骸春共老灯前夫妇月同圆	jing li xing hai chun gong lao deng qian fu fu yue tong yuan	903
精神不是能玄会颜色安知非滥竽	jing shen bu shi neng xuan hui yan se an zhi fei lan yu	388
警世	jing shi	1207
经时不去看梅花窗前一树通开彻	jing shi bu qu kan mei hua chuang qian yi shu tong kai che	720
酒罢茶余思兀然未能除得旧琴缘	jiu ba cha yu si wu ran wei neng chu de jiu qin yuan	413
酒波汨汨翻荷叶别思茫茫在柳条	jiu bo mi mi fan he ye bie si mang mang zai liu tiao	797
酒家急就浅磈磊取醉还酬个里诗	jiu jia ji jiu qian kui lei qu zui hai chou ge li shi	352
酒旗瘦马行人路灯火荒鸡细雨中	jiu qi shou ma xing ren lu deng huo huang ji xi yu zhong	79
旧曲不弹瑶瑟怨秋风秋雨梦潇湘	jiu qu bu tan yao se yuan qiu feng qiu yu meng xiao xiang	571
九日风高斗笠斜篱头对酌酒频赊	jiu ri feng gao dou li xie li tou dui zhuo jiu pin she	496
酒深尚觉冰生脚何事溪桥有客	jiu shen shang jue bing sheng jiao he shi xi qiao you ke	678
九十春光一掷梭花前酌酒唱高歌	jiu shi chun guang yi zhi suo hua qian zhuo jiu chang gao ge	1197
旧时记得诗家说落日下山人影长	jiu shi ji de shi jia shuo luo ri xia shan ren ying chang	127
旧时姚魏种高压洛阳城	jiu shi yao wei zhong gao ya luo yang cheng	663
九十诏光梭脱手多情又作一番愁	jiu shi zhao guang suo tuo shou duo qing you zuo yi fan chou	771
酒醒只在花前坐酒醉换来花下眠	jiu xing zhi zai hua qian zuo jiu zui huan lai hua xia mian	1243
久阳芳草笛悠悠春尽惊看又转头	jiu yang fang cao di you you chun jin jing kan you zhuan tou	774
鸠雨初晴苦竹生满江明月动秋声	jiu yu chu qing ku zhu sheng man jiang ming yue dong qiu sheng	392
酒资尽在东篱下散贮黄金万斛钱	jiu zi jin zai dong li xia san zhu huang jin wan hu qian	483
菊花图	ju hua tu	497
举头红日白云低四海五湖皆一望	ju tou hong ri bai yun di si hai wu hu jie yi wang	1174
菊图	ju tu	397
倦绣图	juan xiu tu	787
君何不烧自家用何必苦心送给人	jun he bu shao zi jia yong he bi ku xin song gei ren	447
君何不自烧些用担水河头卖与人	jun he bu zi shao xie yong dan shui he tou mai yu ren	1053
君令自称亦私淑渔钓须当借一湾	jun ling zi cheng yi si shu yu diao xu dang jie yi wan	468
开门七件事	kai men qi jian shi	340
看花拼逐纷纷蝶消得青丝几两鞋	kan hua pin zhu fen fen die xiao de qing si ji liang xie	56
看花起早月方斜	kan hua qi zao yue fang xie	974
看泉听风图	kan quan ting feng tu	644
堪慰乡间观稼穑应羞枯寂目空人	kan wei xiang jian guan jia se ying xiu ku ji mu kong ren	1
可比君子人穷年交不易	ke bi jun zi ren qiong nian jiao bu yi	366
科斗店前山积铁蛤蟆陵下洒倾酒	ke dou dian qian shan ji tie ha ma ling xia sa qing jiu	687
肯唱骊歌送春去悔教羯鼓彻明催	ken chang li ge song chun qu hui jiao jie gu che ming cui	768
肯嫌斗栗囊钱少也济先生一日穷	ken xian dou li nang qian shao ye ji xian sheng yi ri qiong	1071
肯信璚花旧游处至今犹唱紫云回	ken xin qiong hua jiu you chu zhi jin you chang zi yun hui	313
空山春尽落花深雨过林阴绿玉新	kong shan chun jin luo hua shen yu guo lin yin lv yu xin	502
空山寂寞人声绝狼虎中间读道经	kong shan ji mo ren sheng jue lang hu zhong jian du dao jing	86
空山绝人迹阒寂如隔世	kong shan jue ren ji qu ji ru ge shi	202
空山岁历晚冰霰义如至	kong shan sui li wan bing xian yi ru zhi	840
空使终年读论语如何不做托孤人	kong shi zhong nian du lun yu ru he bu zuo tuo gu ren	307
恐有鲤鱼鳞甲变龙门三月要蜚腾	kong you li yu lin jia bian long men san yue yao fei teng	52
哭妓徐素	ku ji xu su	1143
枯木图	ku mu tu	459
枯木萧疏下夕阳漫烧飞叶煮黄鲿	ku mu xiao shu xia xi yang man shao fei ye zhu huang chang	458
枯木竹石图	ku mu zhu shi tu	575
匡床自拂眠清画一缕茶烟扬鬓丝	kuang chuang zi fu mian qing hua yi lv cha yan yang bin si	747
狂风骤雨暗江千萧籁山中夏亦寒	kuang feng zhou yu an jiang qian xiao lai shan zhong xia yi han	655
匡庐山高高几重山雨山浓复浓	kuang lu shan gao gao ji chong shan yu shan nong fu nong	870
匡山新霁图	kuang shan xin ji tu	805
昆仑琵琶凉州歌当时进御染云和	kun lun pi pa liang zhou ge dang shi jin yu ran yun he	598
赖得泉声引归路泉声鸣咽路高低	lai de quan sheng yin gui lu quan sheng ming ye lu gao di	80
烂开赚我平添老知到来年可烂开	lan kai zhuan wo ping tian lao zhi dao lai nian ke lan kai	767
郎道不如花窈窕	lang dao bu ru hua yao tiao	1265
老我近来多肺疾如另紫雪把烦襟	lao wo jin lai duo fei ji ru ling zi xue ba fan jin	851
李白才名天下奇开元人主最相知	li bai cai ming tian xia qi kai yuan ren zhu zui xiang zhi	158
李白能诗复能酒我今百杯复千首	li bai neng shi fu neng jiu wo jin bai bei fu qian shou	932
李白前时原有月惟有李白诗能说	li bai qian shi yuan you yue wei you li bai shi neng shuo	936
李白如今已仙去月在青天几圆缺	li bai ru jin yi xian qu yue zai qing tian ji yuan que	935
李白图	li bai tu	159
李端端落籍图	li duan duan luo ji tu	635
骊歌送别三年客鲸海遄征万里家	li ge song bie san nian ke jing hai chuan zheng wan li jia	1092
梨花风静鸟栖枝	li hua feng jing niao qi zhi	1249
鲤鱼风急系轻舟两岸寒山宿雨收	li yu feng ji xi qing zhou liang an han shan su yu shou	1178
立锥莫笑无余地万里江山笔下生	li zhui mo xiao wu yu di wan li jiang shan bi xia sheng	892
帘垂菡萏花开上	lian chui han dan hua kai shang	1230
莲花冠子道人衣日侍君王宴紫徽	lian hua guan zi dao ren yi ri shi jun wang yan zi hui	646
炼金丹指修仙求道从禅信佛念经	lian jin dan zhi xiu xian qiu dao cong chan xin fo nian jing	1215
怜卿自是多情者犹有多情在后头	lian qing zi shi duo qing zhe you you duo qing zai hou tou	257
怜渠缟素真吾匹对比清臞即故知	lian qu gao su zhen wu pi dui bi qing qu ji gu zhi	219
濂溪图	lian xi tu	312
两人活计山水中东西路隔万千里	liang ren huo ji shan shui zhong dong xi lu ge wan qian li	864
潦凈泉声涩秋高木影疏	liao cheng quan sheng se qiu gao mu ying shu	198
料得南窗下清风满鬓丝	liao de nan chuang xia qing feng man bin si	666
列坐申王兴岐薜让皇降席同南面	lie zuo shen wang xing qi bi rang huang jiang xi tong nan mian	599
林坳树底跨浮漂一泉玉泻秋琳琅	lin ao shu di kua fu piao yi quan yu xie qiu lin lang	357
邻东谢却看花伴陌上无心手共携	lin dong xie que kan hua ban mo shang wu xin shou gong xie	755
临阶思数脂千片绕树空烦绣半钩	lin jie si shu zhi qian pian rao shu kong fan xiu ban gou	772
临流试罢金徽拂流水冷冷写七弦	lin liu shi ba jin hui fu liu shui leng leng xie qi xian	412
临流试琴图	lin liu shi qin tu	414
邻翁挈盒乘清早来决输赢昨日棋	lin weng qie he cheng qing zao lai jue shu ying zuo ri qi	76
临终诗	lin zhong shi	1029
领解后谢主司	ling jie hou xie zhu si	875
领解皇都第一名猖披归卧旧茅蘅	ling jie huang du di yi ming chang pi gui wo jiu mao heng	893
令我图其所居景烟树茫茫浑水墨	ling wo tu qi suo ju jing yan shu mang mang hun shui mo	329
六鳌并驾神仙府	liu ao bing jia shen xian fu	1257
六代寝陵埋国媛五陵车马斗家姬	liu dai qin ling mai guo yuan wu ling che ma dou jia ji	756
六如偈送钱塘妾八斗才逢洛水神	liu ru ji song qian tang qie ba dou cai feng luo shui shen	776
流水诗	liu shui shi	1154
漏刻已随香篆了钱囊甘为酒杯空	lou ke yi sui xiang zhuan le qian nang gan wei jiu bei kong	744
庐山	lu shan	871
卢仝煎茶图	lu tong jian cha tu	303
芦苇萧萧野渚秋满蓑风雨独归舟	lu wei xiao xiao ye zhu qiu man suo feng yu du gui zhou	91
鸾钗压鬓髻偏新雾湿云低别种情	luan chai ya bin ji pian xin wu shi yun di bie zhong qing	261
乱流寻梵剎洒酒泻襟期	luan liu xun fan cha sa jiu xie jin qi	830
落花诗	luo hua shi	1052
落花图	luo hua tu	503
落花图咏	luo hua tu yong	779
落日山逾碧孤亭景自幽	luo ri shan yu bi gu ting jing zi you	212
落叶风中稻满场平畴相对瀼东庄	luo ye feng zhong dao man chang ping chou xiang dui rang dong zhuang	531
绿肥红瘦忆当时年少朦胧慕燕儿	lv fei hong shou yi dang shi nian shao meng long mu yan er	12
吕蒙正雪景图	lv meng zheng xue jing tu	318
绿树含春雨青山护晓烟	lv shu han chun yu qing shan hu xiao yan	192
绿水红桥夹杏花数间茅屋似仙家	lv shui hong qiao jia xing hua shu jian mao wu si xian jia	151
绿崖入翠微岚气湿罗衣	lv ya ru cui wei lan qi shi luo yi	579
绿阴清画白猿啼三峡桥边路欲迷	lv yin qing hua bai yuan ti san xia qiao bian lu yu mi	81
绿云飞兴风翎长翠葆轻摇玉节香	lv yun fei xing feng ling chang cui bao qing yao yu jie xiang	572
绿云架上草龙蟠马乳含秋露下干	lv yun jia shang cao long pan ma ru han qiu lu xia gan	395
满地风霜菊绽金醉来还弄不弦琴	man di feng shuang ju zhan jin zui lai hai nong bu xian qin	486
漫劳海内传名字谁论腰间缺酒钱	man lao hai nei chuan ming zi shui lun yao jian que jiu qian	1210
漫劳海内传名字谁信腰间没酒钱	man lao hai nei chuan ming zi shui xin yao jian mei jiu qian	1057
满树天香书掩门无端春意褪红焜	man shu tian xiang shu yan men wu duan chun yi tui hong kun	254
满榻乱书尘漠漠数声笛月苍苍	man ta luan shu chen mo mo shu sheng di yue cang cang	453
茅屋风清槐影高白头并坐讲离骚	mao wu feng qing huai ying gao bai tou bing zuo jiang li sao	670
茅屋风清图	mao wu feng qing tu	671
梅花烂熳小轩前鹤氅来看雪齐天	mei hua lan man xiao xuan qian he chang lai kan xue qi tian	614
梅花图	mei hua tu	612
梅花月落江南梦	mei hua yue luo jiang nan meng	941
美景良辰淌遭遇又有赏心并乐事	mei jing liang chen tang zao yu you you shang xin bing le shi	733
美人对月	mei ren dui yue	1251
美人蕉图	mei ren jiao tu	570
美人图	mei ren tu	541
梅枝图	mei zhi tu	785
梅子坠花茭孕笋江南山郭朝晖静	mei zi zhui hua jiao yun sun jiang nan shan guo zhao hui jing	716
梦断碧纱橱窗外闻鹈鴃	meng duan bi sha chu chuang wai wen ti jue	566
梦回蝴蝶巫山庙	meng hui hu die wu shan miao	706
孟蜀宫妓图	meng shu gong ji tu	647
梦仙草堂图	meng xian cao tang tu	378
梦仙图	meng xian tu	288
迷途无往驾款款何从将	mi tu wu wang jia kuan kuan he cong jiang	1170
面蘗才交情谊厚孔方兄与往来疏	mian bo cai jiao qing yi hou kong fang xiong yu wang lai shu	1129
眠牛立马谁家牧鸂鶒鸬鹢无数飞	mian niu li ma shui jia mu xi chi lu yi wu shu fei	823
面前斟酒酒未寒面未变时心已变	mian qian zhen jiu jiu wei han mian wei bian shi xin yi bian	880
妙龄劝赏雄浑语达士耻随迂阔夫	miao ling quan shang xiong hun yu da shi chi sui yu kuo fu	14
名不显时心不朽再挑灯火看文章	ming bu xian shi xin bu xiu zai tiao deng huo kan wen zhang	1163
明窗坐相对试问兴如何	ming chuang zuo xiang dui shi wen xing ru he	573
名利悠悠两不羁闲身偏与鹤相宜	ming li you you liang bu ji xian shen pian yu he xiang yi	220
明日河桥重回首月明千里故人遥	ming ri he qiao zhong hui shou yue ming qian li gu ren yao	1109
明月易亏花易老	ming yue yi kui hua yi lao	987
明月一天风满地爽人秋意不须多	ming yue yi tian feng man di shuang ren qiu yi bu xu duo	152
莫趁螳螂失巢穴有人拈弹不相铙	mo chen tang lang shi chao xue you ren nian dan bu xiang nao	562
莫道英雄今没有谁人看在眼睛中	mo dao ying xiong jin mei you shui ren kan zai yan jing zhong	289
莫负心期飘泊路岂知身锁静安楼	mo fu xin qi piao bo lu qi zhi shen suo jing an lou	27
莫将花月作寻常	mo jiang hua yue zuo xun chang	962
墨菊图	mo ju tu	490
莫贪婪	mo tan lan	449
莫嫌此地风波恶处处风波处处愁	mo xian ci di feng bo e chu chu feng bo chu chu chou	90
莫言此地崎岖甚世上风波更不平	mo yan ci di qi qu shen shi shang feng bo geng bu ping	533
莫言娇细全无事一夜嬠车响到明	mo yan jiao xi quan wu shi yi ye can che xiang dao ming	465
莫言四海皆兄长骨肉而今冷眼看	mo yan si hai jie xiong zhang gu rou er jin leng yan kan	559
谋写一枝新竹卖市中笋价贱如泥	mou xie yi zhi xin zhu mai shi zhong sun jia jian ru ni	1073
暮春林壑图	mu chun lin he tu	629
牡丹图	mu dan tu	538
牡丹图扇面	mu dan tu shan mian	665
木叶飘摇涧水寒田衣合事又驴鞍	mu ye piao yao jian shui han tian yi he shi you lv an	100
难将心事和人说	nan jiang xin shi he ren shuo	1248
难将心事和人说说与青天明月知	nan jiang xin shi he ren shuo shuo yu qing tian ming yue zhi	276
南山多少悠悠意千载无人会此心	nan shan duo shao you you yi qian zai wu ren hui ci xin	485
南山之麓上腴田当守犁锄业玛迁	nan shan zhi lu shang yu tian dang shou li chu ye ma qian	528
南游图	nan you tu	692
内园歌舞黄金画南国飘雪白发长	nei yuan ge wu huang jin hua nan guo piao xue bai fa chang	454
能赋相如已倦游伤春杜甫不禁愁	neng fu xiang ru yi juan you shang chun du fu bu jin chou	766
你在在何方弄调撇得我纱窗月晓	ni zai zai he fang nong tiao pie de wo sha chuang yue xiao	702
蔫红销骨乍攒堆灌顶醍醐志未颓	nian hong xiao gu zha cuan dui guan ding ti hu zhi wei tui	32
捻花玩月醉留霞	nian hua wan yue zui liu xia	970
拈花微笑破檀唇悟得尘埃色身相	nian hua wei xiao po tan chun wu de chen ai se shen xiang	505
年年和月醉花枝	nian nian he yue zui hua zhi	994
廿载龙沙应念我他年笔下可抽丝	nian zai long sha ying nian wo ta nian bi xia ke chou si	9
鸟声花影留人住不赏东风也是痴	niao sheng hua ying liu ren zhu bu shang dong feng ye shi chi	513
宁垦良田三百亩不教堆起一坟丘	ning ken liang tian san bai mu bu jiao dui qi yi fen qiu	25
牛郎织女年年会可惜容颜永别离	niu lang zhi nv nian nian hui ke xi rong yan yong bie li	1036
弄月吟花有几人	nong yue yin hua you ji ren	1002
女弟新承宠阿大李延年	nv di xin cheng chong a da li yan nian	845
女几山前春雪消路傍仙杏发柔条	nv ji shan qian chun xue xiao lu bang xian xing fa rou tiao	682
女几山前野路横松声偏解合泉声	nv ji shan qian ye lu heng song sheng pian jie he quan sheng	781
女梦与青松本是当缠绵	nv meng yu qing song ben shi dang chan mian	843
女人	nv ren	337
哦诗想入秋塘景鸳鹭惊飞一夕忙	o shi xiang ru qiu tang jing yuan lu jing fei yi xi mang	418
怕今宵琴瑟怕今宵琴瑟	pa jin xiao qin se pa jin xiao qin se	703
盘桓坐到日灼午互相话说情何浓	pan huan zuo dao ri zhuo wu hu xiang hua shuo qing he nong	862
培风鸟瞰只神游闹罢琼枝又恁愁	pei feng niao kan zhi shen you nao ba qiong zhi you nen chou	28
鹏程塌翼飞花谢萍叶开心碎骨施	peng cheng ta yi fei hua xie ping ye kai xin sui gu shi	10
蓬莱弱水三千里王母蝠桃一万年	peng lai ruo shui san qian li wang mu fu tao yi wan nian	557
烹鲜热酒招舍己沧浪迭唱仿扣舷	peng xian re jiu zhao she ji cang lang die chang fang kou xian	818
琵琶美人图	pi pa mei ren tu	567
譬若古贞士终身伴菜根	pi ruo gu zhen shi zhong shen ban cai gen	324
贫士吟	pin shi yin	1079
平村泉石足幽栖暖着田衣饱青藜	ping cun quan shi zu you qi nuan zhe tian yi bao qing li	130
平康脂粉知多少可有相同颜色无	ping kang zhi fen zhi duo shao ke you xiang tong yan se wu	536
平生不敢轻言语一叫千门万户开	ping sheng bu gan qing yan yu yi jiao qian men wan hu kai	1183
平生固如此松竹谐素音	ping sheng gu ru ci song zhu xie su yin	206
平生吾亦信吾痴抽身欲往良不疑	ping sheng wu yi xin wu chi chou shen yu wang liang bu yi	353
娉婷红粉歌金缕歌与桃花柳絮听	ping ting hong fen ge jin lv ge yu tao hua liu xu ting	498
萍踪两度到中华归国凭将涉历夸	ping zong liang du dao zhong hua gui guo ping jiang she li kua	1094
破布衫巾破布裙逢人便说会烧银	po bu shan jin po bu qun feng ren bian shuo hui shao yin	448
破衣衫中破布裙逢人便说会烧银	po yi shan zhong po bu qun feng ren bian shuo hui shao yin	1054
扑檐直破帘衣碧上砌如欺地锦红	pu yan zhi po lian yi bi shang qi ru qi di jin hong	1049
浦中浮乳鸭木抄屾平山	pu zhong fu ru ya mu chao shen ping shan	675
骑犊归来浇葑田角端轻挂汉编年	qi du gui lai jiao feng tian jiao duan qing gua han bian nian	111
起对镜自添百媚至今都学寿阳妆	qi dui jing zi tian bai mei zhi jin dou xue shou yang zhuang	520
齐后图	qi hou tu	294
麒麟阁上丹青笔要画须看得见难	qi lin ge shang dan qing bi yao hua xu kan de jian nan	106
绮罗队里挥金客红粉丛中夺锦人	qi luo dui li hui jin ke hong fen cong zhong duo jin ren	102
骑驴八月下蓝关借宿南州白塔湾	qi lv ba yue xia lan guan jie su nan zhou bai ta wan	155
七律诗咏齐云山	qi lv shi yong qi yun shan	1132
七律诗赠恩师梁储以表夺魁之志	qi lv shi zeng en shi liang chu yi biao duo kui zhi zhi	1162
凄凄白露零百卉谢芬芳	qi qi bai lu ling bai hui xie fen fang	1172
乞巧楼前乞巧时金针玉指弄春丝	qi qiao lou qian qi qiao shi jin zhen yu zhi nong chun si	1037
绮疏遗恨之尺	qi shu yi hen zhi chi	1044
绮疏遗恨之刀	qi shu yi hen zhi dao	1041
绮疏遗恨之灯擎	qi shu yi hen zhi deng qing	1032
绮疏遗恨之绣床	qi shu yi hen zhi xiu chuang	1035
绮疏遗恨之针	qi shu yi hen zhi zhen	1038
漆园椿树千年色堂北萱根三月花	qi yuan chun shu qian nian se tang bei xuan gen san yue hua	511
齐云山与壁云齐四顾青山座座低	qi yun shan yu bi yun qi si gu qing shan zuo zuo di	1126
恰似春雷未惊蛰髯龙头角暂皤泥	qia si chun lei wei jing zhe ran long tou jiao zan po ni	651
恰似老夫高兴在醉欹纱帽颔春风	qia si lao fu gao xing zai zui qi sha mao han chun feng	385
铅华梦	qian hua meng	456
乾坤千古兴亡迹公是公非总陆沉	qian kun qian gu xing wang ji gong shi gong fei zong lu chen	621
千年基王业来游有所思	qian nian ji wang ye lai you you suo si	827
千年想见王南海曾借龙王一阵风	qian nian xiang jian wang nan hai ceng jie long wang yi zhen feng	1088
浅浅水长悠悠来无尽去无休	qian qian shui chang you you lai wu jin qu wu xiu	1153
浅浅水断又续	qian qian shui duan you xu	342
浅浅水断又续在山清出山浊	qian qian shui duan you xu zai shan qing chu shan zhuo	1149
千载经纶一秃翁王公谁不仰高风	qian zai jing lun yi tu weng wang gong shui bu yang gao feng	302
巧画斑衣相向舞双亲从此寿无涯	qiao hua ban yi xiang xiang wu shuang qin cong ci shou wu ya	510
且将杯酒送愁魂明朝再去寻佳处	qie jiang bei jiu song chou hun ming chao zai qu xun jia chu	723
秦淮海图	qin huai hai tu	300
琴心挑取卓王孙买酒临邛石冻春	qin xin tiao qu zhuo wang sun mai jiu lin qiong shi dong chun	472
请把世情详细看大都谁不逐炎凉	qing ba shi qing xiang xi kan da dou shui bu zhu yan liang	1122
清波双佩寂无踪情爱悠悠怨恨重	qing bo shuang pei ji wu zong qing ai you you yuan hen zhong	1142
晴窗展轴观图画淡墨依然见古贤	qing chuang zhan zhou guan tu hua dan mo yi ran jian gu xian	507
轻帆带影掠双凫顷刻钱塘三百里	qing fan dai ying lue shuang fu qing ke qian tang san bai li	354
请君细点眼前人一年一度埋荒草	qing jun xi dian yan qian ren yi nian yi du mai huang cao	921
磬口山茶绿萼梅深红浅白一时开	qing kou shan cha lv e mei shen hong qian bai yi shi kai	69
请郎今日伴花眠	qing lang jin ri ban hua mian	1261
青藜竹杖寻诗处多在平桥野寺中	qing li zhu zhang xun shi chu duo zai ping qiao ye si zhong	98
清明时节斜阳里个个行人问酒家	qing ming shi jie xie yang li ge ge xing ren wen jiu jia	515
青青不老真仙草别有阳春雨露恩	qing qing bu lao zhen xian cao bie you yang chun yu lu en	793
晴色湖光	qing se hu guang	662
青山白发老痴顽笔砚生涯苦食艰	qing shan bai fa lao chi wan bi yan sheng ya ku shi jian	1076
青山读书图	qing shan du shu tu	364
青松满山响樵斧白舸落日晒客衣	qing song man shan xiang qiao fu bai ge luo ri shai ke yi	824
清溪松阴图	qing xi song yin tu	653
清怨托琵琶怨极终难说	qing yuan tuo pi pa yuan ji zhong nan shuo	565
青云连风阁白发映鱼矶	qing yun lian feng ge bai fa ying yu ji	346
青云台殿泉声隔黄叶关河雁影来	qing yun tai dian quan sheng ge huang ye guan he yan ying lai	789
穷时多少英雄伴名字应留夹袋中	qiong shi duo shao ying xiong ban ming zi ying liu jia dai zhong	316
秋成烂煮长腰半春作先驱丫髻奴	qiu cheng lan zhu chang yao ban chun zuo xian qu ya ji nu	223
秋风怀归图	qiu feng huai gui tu	375
秋光满眼无殊品笑傲东篱羡尔荣	qiu guang man yan wu shu pin xiao ao dong li xian er rong	491
秋来纨扇合收藏何事佳人重感情	qiu lai wan shan he shou cang he shi jia ren zhong gan qing	1123
秋老芙蓉一夜霜月光潋滟荡湖光	qiu lao fu rong yi ye shuang yue guang lian yan dang hu guang	115
秋圃杂花图	qiu pu za hua tu	400
秋千荡舞腰肢嫩窈窕娇娜与云平	qiu qian dang wu yao zhi nen yao tiao jiao nuo yu yun ping	422
秋日山居图	qiu ri shan ju tu	547
秋声肃杀本天真即事关心总动神	qiu sheng su sha ben tian zhen ji shi guan xin zong dong shen	4
秋塘诗景图	qiu tang shi jing tu	420
秋月攀仙桂春风看杏花	qiu yue pan xian gui chun feng kan xing hua	200
秋月溶溶照佛寺	qiu yue rong rong zhao fo si	1223
去年花病月昏时	qu nian hua bing yue hun shi	982
区区已作老村庄英雄才彦不敢当	qu qu yi zuo lao cun zhuang ying xiong cai yan bu gan dang	879
曲曲折折难回头呜呜咽咽日夜哭	qu qu zhe zhe nan hui tou wu wu ye ye ri ye ku	1148
曲曲折折向东流山山岭岭难阻留	qu qu zhe zhe xiang dong liu shan shan ling ling nan zu liu	1152
犬吠嘹嘹惊夜梦月明千里故人来	quan fei liao liao jing ye meng yue ming qian li gu ren lai	54
泉头自趺坐鹃声出枫树	quan tou zi fu zuo juan sheng chu feng shu	201
却恨画工无见识动人情处不曾描	que hen hua gong wu jian shi dong ren qing chu bu ceng miao	1136
群仙无处追迹却自持来荐寿卮	qun xian wu chu zhui ji que zi chi lai jian shou zhi	630
扰景念畴昔肝裂魂飘扬	rao jing nian chou xi gan lie hun piao yang	1168
绕树百回心语口明年勾管是何人	rao shu bai hui xin yu kou ming nian gou guan shi he ren	739
忍把残红扫作堆粉粉雨里毁垣颓	ren ba can hong sao zuo dui fen fen yu li hui yuan tui	770
人家联络住青山良朋好友时往还	ren jia lian luo zhu qing shan liang peng hao you shi wang huan	361
人间道路江南北地上风波世古今	ren jian dao lu jiang nan bei di shang feng bo shi gu jin	1120
人尽不堪公转乐满头明月脱纱巾	ren jin bu kan gong zhuan le man tou ming yue tuo sha jin	240
人静莺聱细花落垂门掩	ren jing ying ao xi hua luo chui men yan	699
人来种杏不虚寻彷佛庐山小径深	ren lai zhong xing bu xu xun pang fo lu shan xiao jing shen	854
人命促光阴急泪痕渍酒清袗湿	ren ming cu guang yin ji lei hen zi jiu qing zhen shi	712
人生不向花前醉花笑人生也是呆	ren sheng bu xiang hua qian zui hua xiao ren sheng ye shi dai	1194
人生几度花和月	ren sheng ji du hua he yue	1011
人生七十古来少前除幼年后除老	ren sheng qi shi gu lai shao qian chu you nian hou chu lao	927
人生在世数蜉蝣转眼乌头换白头	ren sheng zai shi shu fu you zhuan yan wu tou huan bai tou	888
人物山水画	ren wu shan shui hua	186
人言死后还三跳我要生前做一场	ren yan si hou hai san tiao wo yao sheng qian zuo yi chang	1164
日来养就昂藏志不逐鸡群伍细儿	ri lai yang jiu ang cang zhi bu zhu ji qun wu xi er	217
日下吟行劳伴侣松阳梦觉许追随	ri xia yin xing lao ban lv song yang meng jue xu zhui sui	218
日长何所事茗碗自赉持	ri zhang he suo shi ming wan zi lai chi	667
日长来此消闲兴一局楸棋对手敲	ri zhang lai ci xiao xian xing yi ju qiu qi dui shou qiao	172
日长全赖棋消遣计取输赢赌买鱼	ri zhang quan lai qi xiao qian ji qu shu ying du mai yu	148
日长深闭草庐眠席下犹余纸里钱	ri zhang shen bi cao lu mian xi xia you yu zhi li qian	546
融融温暖香肌体牡丹芍药都难比	rong rong wen nuan xiang ji ti mu dan shao yao dou nan bi	617
溶溶月里花千朵	rong rong yue li hua qian duo	1023
如此福缘消不尽半生落魄太平人	ru ci fu yuan xiao bu jin ban sheng luo po tai ping ren	1102
如此好花如此月	ru ci hao hua ru ci yue	963
如何不把瑶琴写为是无人姓是钟	ru he bu ba yao qin xie wei shi wu ren xing shi zhong	642
如今颜色还依旧风雨江东月润三	ru jin yan se hai yi jiu feng yu jiang dong yue run san	404
儒生作计太痴呆业在毛锥与砚台	ru sheng zuo ji tai chi dai ye zai mao zhui yu yan tai	895
若到长安见知己为言贫甚转工诗	ruo dao chang an jian zhi ji wei yan pin shen zhuan gong shi	415
若非纤手抽刀斩应笑山东后有人	ruo fei qian shou chou dao zhan ying xiao shan dong hou you ren	292
若干生命若干春有所丰收有所贫	ruo gan sheng ming ruo gan chun you suo feng shou you suo pin	40
若将富贵比贫贱一在平地一在天	ruo jiang fu gui bi pin jian yi zai ping di yi zai tian	1239
若将贫贱比车马他得驱驰我得闲	ruo jiang pin jian bi che ma ta dei qu chi wo de xian	1238
若使画师描作画画师应道画难工	ruo shi hua shi miao zuo hua hua shi ying dao hua nan gong	1189
飒飒金飙拂素英倚栏璚朵入杯明	sa sa jin biao fu su ying yi lan qiong duo ru bei ming	492
塞翁得失浑无累胸次悠然觉静虚	sai weng de shi hun wu lei xiong ci you ran jue jing xu	1128
三板桫船叶不如随风漂泊在清渠	san ban suo chuan ye bu ru sui feng piao bo zai qing qu	119
三杯酩酊破愁城醒时愁绪应还又	san bei ming ding po chou cheng xing shi chou xu ying huan you	721
三策举场非古赋上天何以得吹嘘	san ce ju chang fei gu fu shang tian he yi de chui xu	872
三策举扬非古赋上天何以得吹嘘	san ce ju yang fei gu fu shang tian he yi de chui xu	1158
三尺银擎隔帐燃欢愉未了散姻缘	san chi yin qing ge zhang ran huan yu wei liao san yin yuan	1031
三顾草庐图	san gu cao lu tu	476
三朋古称寿七秩世云稀	san peng gu cheng shou qi zhi shi yun xi	350
三天门吏葛长庚体坐蟾蜍赤脚行	san tian men li ge chang geng ti zuo chan chu chi jiao xing	279
桑出罗兮柘出绫绫罗妆束出娉婷	sang chu luo xi zhe chu ling ling luo zhuang shu chu ping ting	499
桑图	sang tu	500
桑维翰铁研图	sang wei han tie yan tu	306
僧房一局金藤着野店三杯石冻春	seng fang yi ju jin teng zhe ye dian san bei shi dong chun	1106
山佃驮柴出换酒邻翁陪坐自捞虾	shan dian tuo chai chu huan jiu lin weng pei zuo zi lao xia	94
善和坊里李端端信是能行白牡丹	shan he fang li li duan duan xin shi neng xing bai mu dan	634
山回水抱独往路深树密迷家	shan hui shui bao du wang lu shen shu mi mi jia	188
山居客至图	shan ju ke zhi tu	609
山居图	shan ju tu	323
山路松声图	shan lu song sheng tu	782
山色浮南岳星辰近少微	shan se fu nan yue xing chen jin shao wei	345
山水画	shan shui hua	174
山水堂轴	shan shui tang zhou	695
山水图	shan shui tu	790
山亭寥落接人稀泥补柴门叶补衣	shan ting liao luo jie ren xi ni bu chai men ye bu yi	61
山翁既醒已然醉野鸟如歌复似啼	shan weng ji xing yi ran zui ye niao ru ge fu si ti	757
山翁要省千年事吩咐家丁买酒杯	shan weng yao sheng qian nian shi fen fu jia ding mai jiu bei	108
山腰隐隐见招提落日长途渺何许	shan yao yin yin jian zhao ti luo ri chang tu miao he xu	358
山意葱茏酿早寒数家茅屋是渔滩	shan yi cong long niang zao han shu jia mao wu shi yu tan	142
善亦懒为何况恶富非所望不忧贫	shan yi lan wei he kuang e fu fei suo wang bu you pin	1107
山隐幽居草木深鸟啼花落书沉沉	shan yin you ju cao mu shen niao ti hua luo shu chen chen	169
赏春合有溪堂约侵晓行过独木桥	shang chun he you xi tang yue qin xiao hang guo du mu qiao	123
商贾经商耕田务农	shang gu jing shang geng tian wu nong	1214
伤内	shang nei	1173
烧丹未住屏风迭骑驴来看香炉峰	shao dan wei zhu ping feng die qi lv lai kan xiang lu feng	869
少年去追不及仰看乌没天凝碧	shao nian qu zhui bu ji yang kan wu mei tian ning bi	711
少年行乐地不许众人知	shao nian xing le di bu xu zhong ren zhi	227
烧药图	shao yao tu	855
射干蔽豫章慨惜自古今	she gan bi yu zhang kai xi zi gu jin	835
身后碑铭徒自好眼前傀儡任他忙	shen hou bei ming tu zi hao yan qian kui lei ren ta mang	908
深虑鬓毛随世白不知腰带几时黄	shen lv bin mao sui shi bai bu zhi yao dai ji shi huang	1165
神识独游天地外低眉宁肯谒王公	shen shi du you tian di wai di mei ning ken ye wang gong	648
深院青春空白锁平原红日又西斜	shen yuan qing chun kong bai suo ping yuan hong ri you xi xie	898
深院人归月伴花	shen yuan ren gui yue ban hua	972
生事事生何日了害人人害几时休	sheng shi shi sheng he ri le hai ren ren hai ji shi xiu	1200
生涯画笔兼诗笔踪迹花边与柳边	sheng ya hua bi jian shi bi zong ji hua bian yu liu bian	904
生意宜从稳处求莫入高山与深水	sheng yi yi cong wen chu qiu mo ru gao shan yu shen shui	856
生在阳间有散场死归地府也何妨	sheng zai yang jian you san chang si gui di fu ye he fang	1028
圣主求贤按画图顷将天秩界胥徙	sheng zhu qiu xian an hua tu qing jiang tian zhi jie xu xi	389
十朝风雨若昏迷八口妻孥并告饥	shi chao feng yu ruo hun mi ba kou qi nu bing gao ji	1078
诗成喜有相过客识取渔梁柱杖声	shi cheng xi you xiang guo ke shi qu yu liang zhu zhang sheng	137
试从静里闲倾耳便觉冲然道气生	shi cong jing li xian qing er bian jue chong ran dao qi sheng	780
是非公论日纷纷不在朝廷在野人	shi fei gong lun ri fen fen bu zai chao ting zai ye ren	587
是非满日纷纷事问我如何总不知	shi fei man ri fen fen shi wen wo ru he zong bu zhi	1083
是非入耳君须忍半作痴呆半作聋	shi fei ru er jun xu ren ban zuo chi dai ban zuo long	1203
十分皓色花输月	shi fen hao se hua shu yue	957
诗赋自惭称作者众人多道我神仙	shi fu zi can cheng zuo zhe zhong ren duo dao wo shen xian	1209
诗赋自惭称作者众人疑道是神仙	shi fu zi can cheng zuo zhe zhong ren yi dao shi shen xian	1056
时花无语不胜情天边雁叫添愁绝	shi hua wu yu bu sheng qing tian bian yan jiao tian chou jue	719
世间乐土是吴中中有阊门更擅雄	shi jian le tu shi wu zhong zhong you chang men geng shan xiong	1192
世间人子非枭獍闻得谁无反哺心	shi jian ren zi fei xiao jing wen de shui wu fan bu xin	379
事茗图	shi ming tu	668
十年行李忆关山纨裤何堪遣路艰	shi nian xing li yi guan shan wan ku he kan qian lu jian	637
十年游赏经行遍多少名题竹树间	shi nian you shang jing xing bian duo shao ming ti zhu shu jian	82
试倩诗人略评品	shi qian shi ren lue ping pin	1228
世人多被鸡催起自不由身为利名	shi ren duo bei ji cui qi zi bu you shen wei li ming	889
世人钱多赚不尽朝里官多做不了	shi ren qian duo zhuan bu jin chao li guan duo zuo bu liao	924
世事如舟挂短篷或移西岸或移东	shi shi ru zhou gua duan peng huo yi xi an huo yi dong	1206
世泰时丰刍米贱买酒颇有青铜钱	shi tai shi feng chu mi jian mai jiu po you qing tong qian	820
世外空青秋一色岩前远黛晓千鬟	shi wai kong qing qiu yi se yan qian yuan dai xiao qian huan	802
拾向砑罗方帕里鸳鸯一对正当中	shi xiang ya luo fang pa li yuan yang yi dui zheng dang zhong	1048
世疑龙虎茌驯扰却许山人擅指挥	shi yi long hu chi xun rao que xu shan ren shan zhi hui	104
诗在浩然驴背上按鞭徐咏夕阳归	shi zai hao ran lv bei shang an bian xu yong xi yang gui	135
十载铅华梦一场都将心事付沧浪	shi zai qian hua meng yi chang dou jiang xin shi fu cang lang	455
诗赠宁王	shi zeng ning wang	1087
试展团蒲坐叶声生早寒	shi zhan tuan pu zuo ye sheng sheng zao han	624
十丈霜根映涧虚五缘茅屋野人居	shi zhang shuang gen ying jian xu wu yuan mao wu ye ren ju	126
士知此位事业成农知此味食廪盈	shi zhi ci wei shi ye cheng nong zhi ci wei shi lin ying	1066
兽额朱扇小院深绿窗含雾静愔愔	shou e zhu shan xiao yuan shen lv chuang han wu jing yin yin	523
守耕图	shou geng tu	529
手拈茉莉腥红朵欲插逢人问可宜	shou nian mo li xing hong duo yu cha feng ren wen ke yi	273
手弄花枝对月吟	shou nong hua zhi dui yue yin	988
书本自惭称学者众人疑道是神仙	shu ben zi can cheng xue zhe zhong ren yi dao shi shen xian	813
数点轻盈娇欲语	shu dian qing ying jiao yu yu	1269
树合泉头围绿阴屋横涧上结黄茅	shu he quan tou wei lv yin wu heng jian shang jie huang mao	173
书画诗文总不工偶然生计寓其中	shu hua shi wen zong bu gong ou ran sheng ji yu qi zhong	1072
蜀锦缠头气若丝风流不减瘦腰肢	shu jin chan tou qi ruo si feng liu bu jian shou yao zhi	252
书生豪气压千军日出扶桑一卷文	shu sheng hao qi ya qian jun ri chu fu sang yi juan wen	305
书生空白头三叹横流涕	shu sheng kong bai tou san tan heng liu ti	838
双脸胭脂开北地五更风雨葬西施	shuang lian yan zhi kai bei di wu geng feng yu zang xi shi	748
霜林着色皆成画雁字排空半草书	shuang lin zhuo se jie cheng hua yan zi pai kong ban cao shu	1130
霜前柿叶一林红树里溪流极望空	shuang qian shi ye yi lin hong shu li xi liu ji wang kong	424
双鹊连成帝子桥	shuang que lian cheng di zi qiao	1256
谁家姊妹斗新妆园林散步频携手	shui jia zi mei dou xin zhuang yuan lin san bu pin xie shou	722
谁将妙笔写风流写到风流处便休	shui jiang miao bi xie feng liu xie dao feng liu chu bian xiu	729
谁叩柴扉惊鹤梦月明千里故人来	shui kou chai fei jing he meng yue ming qian li gu ren lai	639
谁叩荆扉惊鹤梦月明千里故人来	shui kou jing fei jing he meng yue ming qian li gu ren lai	120
水色山光明几上松阴竹影度窗前	shui se shan guang ming ji shang song yin zhu ying du chuang qian	171
谁识一般清意味江南今复有逋仙	shui shi yi ban qing yi wei jiang nan jin fu you bu xian	613
水亭幽居图	shui ting you ju tu	626
谁信深溪狼虎里满身风雨是渔人	shui xin shen xi lang hu li man shen feng yu shi yu ren	283
谁信扬州金满市胭脂价到属穷酸	shui xin yang zhou jin man shi yan zhi jia dao shu qiong suan	633
水养灵苗石养根根苗都在小池盆	shui yang ling miao shi yang gen gen miao dou zai xiao chi pen	794
说法双关如此乐听诗万首向何忧	shuo fa shuang guan ru ci le ting shi wan shou xiang he you	22
说与青天明月知	shuo yu qing tian ming yue zhi	1247
四海横行无立草妖蛇那得阻前驱	si hai heng xing wu li cao yao she na dei zu qian qu	477
司空幕府逼晨开平善街头日夜来	si kong mu fu bi chen kai ping shan jie tou ri ye lai	314
思秋香	si qiu xiang	433
四月江南农事兴沤麻浸谷有常程	si yue jiang nan nong shi xing ou ma jin gu you chang cheng	466
宋朝受命政维新魏国称为社稷臣	song chao shou ming zheng wei xin wei guo cheng wei she ji chen	308
松间草阁依岩开阁下幽花绕露台	song jian cao ge yi yan kai ge xia you hua rao lu tai	121
松间草阁倚岩开岩下幽花娆露台	song jian cao ge yi yan kai yan xia you hua rao lu tai	640
松萝深径积莓苔何事荆扉夜半开	song luo shen jing ji mei tai he shi jing fei ye ban kai	55
松涛谡谡响秋风云影峦光凈太空	song tao su su xiang qiu feng yun ying luan guang cheng tai kong	694
松阴满地凝空翠肯逐朱门褦襶流	song yin man di ning kong cui ken zhu zhu men nai dai liu	92
松竹图	song zhu tu	208
簌簌肥辞删老调萧萧瘦语寄恒春	su su fei ci shan lao diao xiao xiao shou yu ji heng chun	3
苏小堤头试翘首碧云暮合隔红楼	su xiao di tou shi qiao shou bi yun mu he ge hong lou	759
苏州剌史白尚书病骨萧条酒盏疏	su zhou la shi bai shang shu bing gu xiao tiao jiu zhan shu	543
岁寒有贞姿孤竹劲而直	sui han you zhen zi gu zhu jin er zhi	368
碎红风里坚心守衔绿檐头远景啼	sui hong feng li jian xin shou xian lv yan tou yuan jing ti	19
岁久人无千日好春深花有几时红	sui jiu ren wu qian ri hao chun shen hua you ji shi hong	1204
岁幕天寒无一事竹时寺里看梅花	sui mu tian han wu yi shi zhu shi si li kan mei hua	338
随手托牙镂板在低头不语暗寻腔	sui shou tuo ya lou ban zai di tou bu yu an xun qiang	270
虽言异乡县岂非往世缘	sui yan yi xiang xian qi fei wang shi yuan	847
她待要罢手我何曾开口	ta dai yao ba shou wo he ceng kai kou	438
他年炼骨轻如叶拟踏风梢散袖行	ta nian lian gu qing ru ye ni ta feng shao san xiu xing	391
他日回銮蜀道中不教审听铃淋雨	ta ri hui luan shu dao zhong bu jiao shen ting ling lin yu	595
他日江州茅屋底年年伏腊赛鸡豚	ta ri jiang zhou mao wu di nian nian fu la sai ji tun	586
踏莎行闺情	ta sha xing gui qing	727
榻上氍毹黄叶满清风日日坐阳春	ta shang qu shu huang ye man qing feng ri ri zuo yang chun	808
太湖西岸景萧疏竹外山旋碧玉螺	tai hu xi an jing xiao shu zhu wai shan xuan bi yu luo	153
苔满西阶人迹断百年相对眼青青	tai man xi jie ren ji duan bai nian xiang dui yan qing qing	806
苔藓作毛因雨长藤萝穿鼻任风牵	tai xian zuo mao yin yu chang teng luo chuan bi ren feng qian	1116
太真图	tai zhen tu	239
探梅图	tan mei tu	615
叹世	tan shi	911
叹世之二	tan shi zhi er	914
叹世之一	tan shi zhi yi	919
唐伯虎与祝枝山联句咏奇石	tang bo hu yu zhu zhi shan lian ju yong qi shi	1118
堂上双白头图	tang shang shuang bai tou tu	387
陶榖赠词图	tao gu zeng ci tu	620
桃花庵歌	tao hua an ge	1246
桃花净尽杏花空开落年年约略同	tao hua jing jin xing hua kong kai luo nian nian yue lue tong	1051
桃花浪暖锦层层勤尔渔郎莫下罨	tao hua lang nuan jin ceng ceng qin er yu lang mo xia yan	53
桃花坞里桃花庵桃花庵下桃花仙	tao hua wu li tao hua an tao hua an xia tao hua xian	1245
桃花仙人种桃树又摘桃花卖酒钱	tao hua xian ren zhong tao shu you zhai tao hua mai jiu qian	1244
桃花雨过水连天古树高岸乱玉泉	tao hua yu guo shui lian tian gu shu gao an luan yu quan	407
桃花雨过图	tao hua yu guo tu	408
桃李春风好放怀斗鸡走狗夕阳街	tao li chun feng hao fang huai dou ji zou gou xi yang jie	57
题碧藻轩	ti bi zao xuan	1235
题画二首	ti hua er shou	156
题画九首	ti hua jiu shou	122
题画廿四首	ti hua nian si shou	96
题画三首	ti hua san shou	103
题画十首	ti hua shi shou	143
题画师周东村之郊秋图	ti hua shi zhou dong cun zhi jiao qiu tu	1179
题画四首	ti hua si shou	183
题菊花图	ti ju hua tu	1135
题倦绣图	ti juan xiu tu	1047
题落霞孤骛图	ti luo xia gu wu tu	1090
题拈花微笑图	ti nian hua wei xiao tu	1101
题齐云山石室壁	ti qi yun shan shi shi bi	1127
啼禽欲歇烟霞暝一对西风落叶秋	ti qin yu xie yan xia ming yi dui xi feng luo ye qiu	131
题秋风纨扇图	ti qiu feng wan shan tu	1124
题沈石田壑舟图	ti shen shi tian he zhou tu	1157
题陶谷赠词图	ti tao gu zeng ci tu	1061
题图赠何炌	ti tu zeng he kai	461
题伍子胥庙壁	ti wu zi xu miao bi	1146
题张梦晋半身美人图	ti zhang meng jin ban shen mei ren tu	1138
天风缥缈约飞泉千尺晴红拂紫烟	tian feng piao miao yue fei quan qian chi qing hong fu zi yan	163
天将花月付闲身	tian jiang hua yue fu xian shen	1008
天开月镜照花妖	tian kai yue jing zhao hua yao	950
天然兴趣难摹写三日无烟不觉饥	tian ran xing qu nan mo xie san ri wu yan bu jue ji	1069
天上秋风发岩前菊蕊黄	tian shang qiu feng fa yan qian ju rui huang	204
天台鹤鹿同人境尚恐翁归向此间	tian tai he lu tong ren jing shang kong weng gui xiang ci jian	801
天涯来旅雁江上有鲈鱼	tian ya lai lv yan jiang shang you lu yu	197
天涯咫尺咫尺情人远	tian ya zhi chi zhi chi qing ren yuan	697
田衣稻衲拟终身弹指流年了四旬	tian yi dao na ni zhong shen tan zhi liu nian le si xun	1103
天姿袅娜十分娇可惜风流半节腰	tian zi niao nuo shi fen jiao ke xi feng liu ban jie yao	1137
跳丸走路微松逝驭马摇鞭不辍催	tiao wan zou lu wei song shi yu ma yao bian bu chuo cui	30
铁骨不教秋色淡满身香汗立东篱	tie gu bu jiao qiu se dan man shen xiang han li dong li	488
铁冠仙史隐城隅西近平畴宅一区	tie guan xian shi yin cheng yu xi jin ping chou zhai yi qu	225
铁研未穿时世改功名回首信浮云	tie yan wei chuan shi shi gai gong ming hui shou xin fu yun	304
听泉人习静伫立面平桥	ting quan ren xi jing zhu li mian ping qiao	213
铜壶玉漏金门下多少王侯勒马听	tong hu yu lou jin men xia duo shao wang hou le ma ting	1186
头扶残醉方中酒面对飞花怕倚楼	tou fu can zui fang zhong jiu mian dui fei hua pa yi lou	765
头如蒜颗眼如椒雄逐雌飞向苇萧	tou ru suan ke yan ru jiao xiong zhu ci fei xiang wei xiao	563
头上红冠不用裁满身雪白走将来	tou shang hong guan bu yong cai man shen xue bai zou jiang lai	1184
褪尽东风满面妆可怜蝶粉与蜂狂	tui jin dong feng man mian zhuang ke lian die fen yu feng kuang	235
脱毂且卷鞭高揖问君廛	tuo gu qie juan bian gao yi wen jun chan	846
瓦盆熟得松花酒刚是溪丁拾蟹归	wa pen shu de song hua jiu gang shi xi ding shi xie gui	144
万场快乐千场醉世上闲人地上仙	wan chang kuai le qian chang zui shi shang xian ren di shang xian	902
万木号风疑虎吼乱泉惊雨挟龙飞	wan mu hao feng yi hu hou luan quan jing yu xie long fei	105
万片风飘难割舍五更人起可能留	wan pian feng piao nan ge she wu geng ren qi ke neng liu	764
万仞芝山接太虚一泓萍水娆吾庐	wan ren zhi shan jie tai xu yi hong ping shui rao wu lu	149
万事由天莫苦求子孙绵远褔悠悠	wan shi you tian mo ku qiu zi sun mian yuan fu you you	1202
万事由天莫强求何须苦苦用机谋	wan shi you tian mo qiang qiu he xu ku ku yong ji mou	913
晚云明漏日春水绿浮山	wan yun ming lou ri chun shui lv fu shan	216
万紫千红莫谩夸今朝粉蝶过邻家	wan zi qian hong mo man kua jin zhao fen die guo lin jia	900
王母东门劣小儿偷桃三度到瑶池	wang mu dong men lie xiao er tou tao san du dao yao chi	631
王母赠寿图	wang mu zeng shou tu	558
为底时来策黎杖春衣要试浴沂天	wei di shi lai ce li zhang chun yi yao shi yu yi tian	627
危椒绝磴走行旅岚气湿衣云作侣	wei jiao jue deng zou xing lv lan qi shi yi yun zuo lv	359
为是仙翁诗帖报鹿场僧寺鲜莓开	wei shi xian weng shi tie bao lu chang seng si xian mei kai	72
未说铜钱起先铺芦席床	wei shuo tong qian qi xian pu lu xi chuang	1080
逶迤十里平溪路滴沥三重下漱泉	wei yi shi li ping xi lu di li san chong xia shu quan	628
为子酌大斗为我调鸣琴	wei zi zhuo da dou wei wo tiao ming qin	833
问郎花好奴颜好	wen lang hua hao nu yan hao	1266
问郎花好奴颜好郎道不如花窈窕	wen lang hua hao nu yan hao lang dao bu ru hua yao tiao	1098
问伊奔腾何时歇不到大海不回头	wen yi ben teng he shi xie bu dao da hai bu hui tou	1151
问伊伤心何其多悔恨当初出幽谷	wen yi shang xin he qi duo hui hen dang chu chu you gu	1147
问字昔人皆载酒写诗亦望买鱼来	wen zi xi ren jie zai jiu xie shi yi wang mai yu lai	894
翁昔少年初画山苍松苍竹杂潺湲	weng xi shao nian chu hua shan cang song cang zhu za chan yuan	804
我爱菜人爱肉肉多不入贤人腹	wo ai cai ren ai rou rou duo bu ru xian ren fu	1063
我爱秋香	wo ai qiu xiang	1226
我当李白对明月月与李白安能知	wo dang li bai dui ming yue yue yu li bai an neng zhi	933
我观古昔之英雄慷慨然诺杯酒中	wo guan gu xi zhi ying xiong kang kai ran nuo bei jiu zhong	883
我观今日之才彦交不以心惟以面	wo guan jin ri zhi cai yan jiao bu yi xin wei yi mian	881
我画蓝江水悠悠	wo hua lan jiang shui you you	1225
我愧虽无李白才料应月不嫌我丑	wo kui sui wu li bai cai liao ying yue bu xian wo chou	931
我来愿结三生友共看当时手指天	wo lai yuan jie san sheng you gong kan dang shi shou zhi tian	41
我随花月泛金卮	wo sui hua yue fan jin zhi	938
我心中恨着我心中恨着	wo xin zhong hen zhe wo xin zhong hen zhe	705
我也奔驰名利人老来静拂尘埃迹	wo ye ben chi ming li ren lao lai jing fu chen ai ji	328
我也不登天子船我也不上长安眠	wo ye bu deng tian zi chuan wo ye bu shang chang an mian	930
我亦嚣嚣好游者何时得醉岳阳楼	wo yi xiao xiao hao you zhe he shi de zui yue yang lou	295
我依住处真堪画借问旁人到未曾	wo yi zhu chu zhen kan hua jie wen pang ren dao wei ceng	181
我欲相随卜居去此身一脱花尘红	wo yu xiang sui bu ju qu ci shen yi tuo hua chen hong	319
我醉欲眠拈一瓣今生弭忘不教枯	wo zui yu mian nian yi ban jin sheng mi wang bu jiao ku	13
舞罢霓裳日色低满身春倦眼迷离	wu ba ni chang ri se di man shen chun juan yan mi li	526
乌柏经霜叶已红东南楼阁足秋风	wu bai jing shuang ye yi hong dong nan lou ge zu qiu feng	180
无风眼界白云悠红雨心波漾尽头	wu feng yan jie bai yun you hong yu xin bo yang jin tou	36
五更市卖何曾绝四远方言总不同	wu geng shi mai he ceng jue si yuan fang yan zong bu tong	1190
无恨伤心多少泪朝来枕上眼应枯	wu hen shang xin duo shao lei chao lai zhen shang yan ying ku	751
吾今与汝要知止凡事中间要谨始	wu jin yu ru yao zhi zhi fan shi zhong jian yao jin shi	857
武距文冠五色翎一声啼散满天星	wu ju wen guan wu se ling yi sheng ti san man tian xing	1187
五柳先生日醉眠客来清赏榻无毡	wu liu xian sheng ri zui mian ke lai qing shang ta wu zhan	484
无情物外谁翻案有限生前我扫尘	wu qing wu wai shui fan an you xian sheng qian wo sao chen	2
无人解得悠悠意行过松阴懒着鞭	wu ren jie de you you yi xing guo song yin lan zhuo bian	110
五十言怀诗	wu shi yan huai shi	1058
乌台十卷青蝇案炎海三千白发臣	wu tai shi juan qing ying an yan hai san qian bai fa chen	241
无题	wu ti	896
五王夜燕图	wu wang ye yan tu	603
吾闻淮水出桐山古来贤哲产其间	wu wen huai shui chu tong shan gu lai xian zhe chan qi jian	469
西北分天堑东南缺地维	xi bei fen tian qian dong nan que di wei	829
西畴图	xi chou tu	226
西风吹叶满庭寒蘗子无言鼻自酸	xi feng chui ye man ting han bo zi wu yan bi zi suan	374
西风鸾背彩旗摇王母乘秋下九霄	xi feng luan bei cai qi yao wang mu cheng qiu xia jiu xiao	555
惜花春起早	xi hua chun qi zao	233
洗爵传浮白悬鱼看赐绯	xi jue chuan fu bai xuan yu kan ci fei	349
淅沥风光摇草树骖驔时节逐川流	xi li feng guang yao cao shu can dian shi jie zhu chuan liu	773
溪山翠图	xi shan cui tu	585
溪山如此人如玉不梦京华空白头	xi shan ru ci ren ru yu bu meng jing hua kong bai tou	133
席上答王履吉	xi shang da wang lv ji	884
溪水东流日转西杏花零落草萋迷	xi shui dong liu ri zhuan xi xing hua ling luo cao qi mi	758
系水接天三万顷晚山连树一千重	xi shui jie tian san wan qing wan shan lian shu yi qian zhong	59
西望太湖山阁月东连沦海地通潮	xi wang tai hu shan ge yue dong lian lun hai di tong chao	798
夕阳半落风浪舞舟船入港无危颠	xi yang ban luo feng lang wu zhou chuan ru gang wu wei dian	819
惜月怜花卧转迟	xi yue lian hua wo zhuan chi	1000
西洲话旧图	xi zhou hua jiu tu	815
夏雨归牧图	xia yu gui mu tu	656
仙娥记曲世无双下直归来日满窗	xian e ji qu shi wu shuang xia zhi gui lai ri man chuang	271
贤侯若问真消息也有声名在凤池	xian hou ruo wen zhen xiao xi ye you sheng ming zai feng chi	442
仙机变幻真难测吕字分明现在哉	xian ji bian huan zhen nan ce lv zi fen ming xian zai zai	552
闲来写就青山卖	xian lai xie jiu qing shan mai	1218
闲来隐几枕书眠梦入壶中别有天	xian lai yin ji zhen shu mian meng ru hu zhong bie you tian	377
献纳亲会批逆鳞忽以谗言弃于野	xian na qin hui pi ni lin hu yi chan yan qi yu ye	592
羡却人间花月意	xian que ren jian hua yue yi	971
相逢若有知音者随地芟茅好结庐	xiang feng ruo you zhi yin zhe sui di shan mao hao jie lu	690
相逢狭邪间车窒马不旋	xiang feng xia xie jian che zhi ma bu xuan	848
乡关阴少悠悠思立马边山看雁飞	xiang guan yin shao you you si li ma bian shan kan yan fei	64
相看经发改独领四时春	xiang kan jing fa gai du ling si shi chun	610
向来行乐城东路青草池塘乱活东	xiang lai xing le cheng dong lu qing cao chi tang luan huo dong	743
香柳娘	xiang liu niang	708
相期与君老湖上香饭鱼羹首同白	xiang qi yu jun lao hu shang xiang fan yu geng shou tong bai	327
相如涤器图	xiang ru di qi tu	473
想煞你当初一见好至诚	xiang sha ni dang chu yi jian hao zhi cheng	432
想煞你花月下好句联吟	xiang sha ni hua yue xia hao ju lian yin	430
想煞你叫着小名儿低声应	xiang sha ni jiao zhe xiao ming er di sheng ying	429
想煞你临别前苦叮宁	xiang sha ni lin bie qian ku ding ning	428
想煞你身材苗条脸儿俊	xiang sha ni shen cai miao tiao lian er jun	431
相思两地望迢迢清泪临门落布袍	xiang si liang di wang tiao tiao qing lei lin men luo bu pao	1112
香烟袅袅绕经楼	xiang yan niao niao rao jing lou	1222
晓林慈鸟图	xiao lin ci niao tu	381
小桥流水闲村落不见啼莺有吠蛙	xiao qiao liu shui xian cun luo bu jian ti ying you fei wa	897
笑舞狂歌五十年花中行乐月中眠	xiao wu kuang ge wu shi nian hua zhong xing le yue zhong mian	1211
萧萧美人脱凡俗蕉姓称罗各碧玉	xiao xiao mei ren tuo fan su jiao xing cheng luo ge bi yu	282
小院疏枝衬日西阶前俯首莫沉迷	xiao yuan shu zhi chen ri xi jie qian fu shou mo chen mi	20
晓月丽尘梁白日照春阳	xiao yue li chen liang bai ri zhao chun yang	1169
斜髻娇娥夜卧迟	xie ji jiao e ye wo chi	1250
卸髻娇娥夜卧迟梨花风静鸟栖枝	xie ji jiao e ye wo chi li hua feng jing niao qi zhi	277
携酒花前带月尝	xie jiu hua qian dai yue chang	964
写就青山卖指卖画	xie jiu qing shan mai zhi mai hua	1213
携筇出矶上何以地行仙	xie qiong chu ji shang he yi di xing xian	191
斜日僧房怕归去还携红袖绕南枝	xie ri seng fang pa gui qu hai xie hong xiu rao nan zhi	783
鞋袜东城路清和四月时	xie wa dong cheng lu qing he si yue shi	230
些须做得工夫处不损胸前一片天	xie xu zuo de gong fu chu bu sun xiong qian yi pian tian	812
些须做得工夫处莫损心头一寸天	xie xu zuo de gong fu chu mo sun xin tou yi cun tian	1208
新草漫生天际绿衰颜又改镜中朱	xin cao man sheng tian ji lv shuai yan you gai jing zhong zhu	753
信口吟成四韵诗自家计较说和谁	xin kou yin cheng si yun shi zi jia ji jiao shuo he shei	1086
心期此日来游赏载酒携琴过野桥	xin qi ci ri lai you shang zai jiu xie qin guo ye qiao	681
信是老天真戏我无人来买扇头诗	xin shi lao tian zhen xi wo wu ren lai mai shan tou shi	1077
心在九泉灯在壁一襟清血泪栏杆	xin zai jiu quan deng zai bi yi jin qing xue lei lan gan	373
幸此地湖山无恙	xing ci di hu shan wu yang	436
兴发总关情自落霞孤鹜秋水长天	xing fa zong guan qing zi luo xia gu wu qiu shui chang tian	437
行歌樵互答醉卧客忘归	xing ge qiao hu da zui wo ke wang gui	577
形骸托与自然寄泥壤终将分子留	xing hai tuo yu zi ran ji ni rang zhong jiang fen zi liu	26
杏林春燕	xing lin chun yan	517
行旅图	xing lv tu	638
行人杖履多迷路不是书声何处寻	xing ren zhang lv duo mi lu bu shi shu sheng he chu xun	168
星振珠光铺锦绣	xing zhen zhu guang pu jin xiu	1255
朽腐何足论壮哉风云气	xiu fu he zu lun zhuang zai feng yun qi	839
嗅花观音图	xiu hua guan yin tu	506
休言鸟断人绝觅句逋仙正不闲	xiu yan niao duan ren jue mi ju bu xian zheng bu xian	480
修竹当窗白日达山僧出定客来时	xiu zhu dang chuang bai ri da shan seng chu ding ke lai shi	549
虚阁静潭潭千山紫翠攒	xu ge jing tan tan qian shan zi cui cuan	196
虚阁临溪足晚凉槛前千斛藕花香	xu ge lin xi zu wan liang kan qian qian hu ou hua xiang	685
虚阁晚凉图	xu ge wan liang tu	686
虚亭林木里傍水着栏杆	xu ting lin mu li bang shui zhe lan gan	625
虚心足以容坚节不挠物	xu xin zu yi rong jian jie bu nao wu	367
萱草图	xuan cao tu	403
雪妒冰猜情愈白云酸日涩笑犹红	xue du bing cai qing yu bai yun suan ri se xiao you hong	7
学佛俄经二十年于今地上拥青莲	xue fo e jing er shi nian yu jin di shang yong qing lian	42
雪满空山晓会琴耸肩驴背自长路	xue man kong shan xiao hui qin song jian lv bei zi chang lu	622
雪满梁园飞鸟稀暖煨榾柮闭柴扉	xue man liang yuan fei niao xi nuan wei gu duo bi chai fei	145
雪满梁园谁解赋当时只数谪仙才	xue man liang yuan shui jie fu dang shi zhi shu zhe xian cai	109
血染冠头锦做翎昂昂气象羽毛新	xue ran guan tou jin zuo ling ang ang qi xiang yu mao xin	1181
雪山会琴图	xue shan hui qin tu	623
雪山行旅图	xue shan xing lv tu	680
雪深山路滑于苔自跨青驴得得来	xue shen shan lu hua yu tai zi kua qing lv de de lai	73
雪压江村阵作寒园林俱是玉花攒	xue ya jiang cun zhen zuo han yuan lin ju shi yu hua cuan	51
雪夜幸赵普	xue ye xing zhao pu	309
寻常乐事难申爱添出余情又一般	xun chang le shi nan shen ai tian chu yu qing you yi ban	247
寻花趁蝶好光阴何须步步回头笑	xun hua chen die hao guang yin he xu bu bu hui tou xiao	725
浔阳送别图	xun yang song bie tu	594
妍媸双脚撩天去千古茫茫土一丘	yan chi shuang jiao liao tian qu qian gu mang mang tu yi qiu	763
言怀	yan huai	1212
眼前多少不平事愿与将军借宝刀	yan qian duo shao bu ping shi yuan yu jiang jun jie bao dao	1144
眼前景好诗难胜炼不成词恼剎人	yan qian jing hao shi nan sheng lian bu cheng ci nao cha ren	74
烟水云山天地宽尽容樵斧与渔竿	yan shui yun shan tian di kuan jin rong qiao fu yu yu gan	107
烟锁垂阳院日长绣帘卷	yan suo chui yang yuan ri zhang xiu lian juan	700
严滩	yan tan	826
雁影横天报早霜松声沿路奏清商	yan ying heng tian bao zao shuang song sheng yan lu zou qing shang	128
眼睁睁望着灯前壁上壁上形怜影	yan zheng zheng wang zhe deng qian bi shang bi shang xing lian ying	426
言志	yan zhi	1221
燕子归来杏子花红桥低影绿池斜	yan zi gui lai xing zi hua hong qiao di ying lv chi xie	516
养个儿子会做贼偷得蟠桃供母亲	yang ge er zi hui zuo zei tou de pan tao gong mu qin	335
杨家红拂识英雄着帽宵奔李卫公	yang jia hong fu shi ying xiong zhe mao xiao ben li wei gong	290
阳间地府俱相似只当漂流在异乡	yang jian di fu ju xiang si zhi dang piao liu zai yi xiang	1027
杨柳晓烟情绪乱梨花暮雨梦魂销	yang liu xiao yan qing xu luan li hua mu yu meng hun xiao	1111
杨柳阴浓夏日迟村边高馆漫平池	yang liu yin nong xia ri chi cun bian gao guan man ping chi	77
仰偃草木间世道随浮沉	yang yan cao mu jian shi dao sui fu chen	832
扬州道上思念沈九娘	yang zhou dao shang si nian shen jiu niang	1113
遥见树木车暂息高蟠潸石与盘桓	yao jian shu mu che zan xi gao pan shan shi yu pan huan	162
腰间小榼藏何物几转芙蓉一颗丹	yao jian xiao ke cang he wu ji zhuan fu rong yi ke dan	175
摇落郊园九月余秋山今日喜登初	yao luo jiao yuan jiu yue yu qiu shan jin ri xi deng chu	1131
遥天两两沙鸥起中有昊船过越水	yao tian liang liang sha ou qi zhong you hao chuan guo yue shui	355
遥望黄尘道中客富贵于我如云	yao wang huang chen dao zhong ke fu gui yu wo ru yun	816
要知尽日支吾处五老峰前三峡桥	yao zhi jin ri zhi wu chu wu lao feng qian san xia qiao	462
野店桃花红粉姿陌头阳柳绿烟丝	ye dian tao hua hong fen zi mo tou yang liu lv yan si	140
野店桃花万树低春光多在画桥西	ye dian tao hua wan shu di chun guang duo zai hua qiao xi	167
夜读	ye du	1167
野芳介石图	ye fang jie shi tu	326
夜合花开香满庭玉人停绣自含情	ye he hua kai xiang man ting yu ren ting xiu zi han qing	1046
野菊日烂漫秋风随分开	ye ju ri lan man qiu feng sui fen kai	210
夜来欹枕细思量独卧残灯漏夜长	ye lai qi zhen xi si liang du wo can deng lou ye chang	1166
夜郎不免长流去今日书生敢望谁	ye lang bu mian chang liu qu jin ri shu sheng gan wang shui	157
夜深花睡月明中	ye shen hua shui yue ming zhong	1012
野水荒亭气象幽山深因少客来游	ye shui huang ting qi xiang you shan shen yin shao ke lai you	132
晔晔桃李花旦暮改颜色	ye ye tao li hua dan mu gai yan se	365
夜雨巫山不尽欢两头颠倒玉龙蟠	ye yu wu shan bu jin huan liang tou dian dao yu long pan	248
义重生轻死知己所以与人成大功	yi chong sheng qing si zhi ji suo yi yu ren cheng da gong	882
一丛楼阁空江上日有群鸥伴苦吟	yi cong lou ge kong jiang shang ri you qun ou ban ku yin	89
一段胜情谁领略幽人虚阁俯沧湾	yi duan sheng qing shui ling lue you ren xu ge fu cang wan	164
一个茅荠如斗大如何容得许多秋	yi ge mao ji ru dou da ru he rong de xu duo qiu	46
一剪梅	yi jian mei	718
一径幽香月让花	yi jing you xiang yue rang hua	956
一卷真经幻作胎人间肉眼误相猜	yi juan zhen jing huan zuo tai ren jian rou yan wu xiang cai	266
倚槛娇无力临风香自生	yi kan jiao wu li lin feng xiang zi sheng	664
一梦熟时鸥作伴锦衾何必抱轻红	yi meng shu shi ou zuo ban jin qin he bi bao qing hong	286
一抹斜阳归雁尽白萍红蓼野塘秋	yi mo xie yang gui yan jin bai ping hong liao ye tang qiu	1177
一年歌	yi nian ge	738
一年三百六十日春夏秋冬各九十	yi nian san bai liu shi ri chun xia qiu dong ge jiu shi	737
一年细算良辰少况且叹逢美景何	yi nian xi suan liang chen shao kuang qie tan feng mei jing he	734
一派银河倾碧落耳根于此洗尘嚣	yi pai yin he qing bi luo er gen yu ci xi chen xiao	463
一曲霓裳未终舞金钿甲委马嵬坡	yi qu ni chang wei zhong wu jin dian jia wei ma wei po	237
一曲琵琶泪如把况是秋风送别时	yi qu pi pa lei ru ba kuang shi qiu feng song bie shi	588
一群嘹呖相呼处多在萍荒浅水洲	yi qun liao li xiang hu chu duo zai ping huang qian shui zhou	409
一上一上又一上一上直到高山上	yi shang yi shang you yi shang yi shang zhi dao gao shan shang	1175
一世歌	yi shi ge	928
一庭花月正春宵	yi ting hua yue zheng chun xiao	953
一宿姻缘逆旅中短词聊以识泥鸿	yi xiu yin yuan ni lv zhong duan ci liao yi shi ni hong	1060
一云江水有巨鳞滔天波浪惊剎人	yi yun jiang shui you ju lin tao tian bo lang jing cha ren	859
一云深山有大木中有猛虎吃人肉	yi yun shen shan you da mu zhong you meng hu chi ren rou	861
瘗葬偕愁无赖锦倾斟饮辱有情杯	yi zang xie chou wu lai jin qing zhen yin ru you qing bei	31
一朝欣得意联步上京华	yi zhao xin de yi lian bu shang jing hua	199
一自韩孟归去后谁人敢把兔毫拈	yi zi han meng gui qu hou shui ren gan ba tu hao nian	672
饮杯酬月浇花酒	yin bei chou yue jiao hua jiu	981
因观赤壁两篇赋不觉苏州夜半时	yin guan chi bi liang pian fu bu jue su zhou ye ban shi	444
银花宝钿金星尺认得纤纤十指香	yin hua bao dian jin xing chi ren de xian xian shi zhi xiang	1042
隐居深在碧山空涧壑才堪侧步通	yin ju shen zai bi shan kong jian he cai kan ce bu tong	322
饮三杯酒休胡乱得一帆风便可收	yin san bei jiu xiu hu luan de yi fan feng bian ke shou	1201
因他一去不归来愁时只是吟芳草	yin ta yi qu bu gui lai chou shi zhi shi yin fang cao	726
映门未遇偷香椽坠溷番成逐臭夫	ying men wei yu tou xiang chuan zhui hun fan cheng zhu chou fu	752
莺莺图	ying ying tu	384
庸夫碌碌惟虚灭烈士昂昂岂罢休	yong fu lu lu wei xu mie lie shi ang ang qi ba xiu	23
咏怀诗	yong huai shi	842
咏鸡诗题金鸡报晓图其二	yong ji shi ti jin ji bao xiao tu qi er	1185
咏鸡诗题金鸡报晓图其三	yong ji shi ti jin ji bao xiao tu qi san	1182
咏鸡诗题金鸡报晓图其一	yong ji shi ti jin ji bao xiao tu qi yi	1188
庸庸碌碌我何奇有酒与君斟酌之	yong yong lu lu wo he qi you jiu yu jun zhen zhuo zhi	876
友鹤图	you he tu	221
有花无月恨茫茫	you hua wu yue hen mang mang	969
游姬香满袖明月水平地	you ji xiang man xiu ming yue shui ping di	229
游焦山	you jiao shan	831
有客隔林借问惊禽蹴落藤花	you ke ge lin jie wen jing qin cu luo teng hua	187
有人独对芭蕉坐因为春愁不放心	you ren du dui ba jiao zuo yin wei chun chou bu fang xin	522
幽人无世事终曰倚栏杆	you ren wu shi shi zhong yue yi lan gan	195
幽人自得寻芳兴马背诗成路欲迷	you ren zi de xun fang xing ma bei shi cheng lu yu mi	166
有伸脚处须伸脚得缩头时且缩头	you shen jiao chu xu shen jiao de suo tou shi qie suo tou	917
又是一番春计了瓦盆儿女共村醪	you shi yi fan chun ji le wa pen er nv gong cun lao	62
游仙抛却丝纶坐只有消闲不为鱼	you xian pao que si lun zuo zhi you xiao xian bu wei yu	118
有月无花恨转长	you yue wu hua hen zhuan chang	968
游镇江登金山焦山	you zhen jiang deng jin shan jiao shan	1121
欲从节下题诗句妙在无言不在诗	yu cong jie xia ti shi ju miao zai wu yan bu zai shi	548
鱼父图	yu fu tu	285
鱼羹稻衲好终身弹指流年到四旬	yu geng dao na hao zhong shen tan zhi liu nian dao si xun	1108
雨霁秋滩带石流过桥心事与悠悠	yu ji qiu tan dai shi liu guo qiao xin shi yu you you	134
欲济时难须异才琐尾小人有何益	yu ji shi nan xu yi cai suo wei xiao ren you he yi	590
渔家乐	yu jia le	821
与君且作忘形醉明日驱驰汗浣裳	yu jun qie zuo wang xing zui ming ri qu chi han huan shang	457
芋栗一园秋计足僮奴百指治生同	yu li yi yuan qiu ji zu tong nu bai zhi zhi sheng tong	321
御袍采采扬妃醉半夜扶归挹露华	yu pao cai cai yang fei zui ban ye fu gui yi lu hua	495
渔樵问答歌	yu qiao wen da ge	866
迂疏任是傍人笑要探梅花信息难	yu shu ren shi bang ren xiao yao tan mei hua xin xi nan	99
渔翁稳作船头睡梦入鲛宫自渺茫	yu weng wen zuo chuan tou shui meng ru jiao gong zi miao mang	114
渔翁舟泊东海边樵夫家住西山里	yu weng zhou bo dong hai bian qiao fu jia zhu xi shan li	865
鱼戏栏杆倒影中	yu xi lan gan dao ying zhong	1229
余香盈翠袖偏惹蝶蜂随	yu xiang ying cui xiu pian re die feng sui	189
遇饮酒时须饮酒青山偏会笑人愁	yu yin jiu shi xu yin jiu qing shan pian hui xiao ren chou	885
欲与阿弥增寿考自斟绿醑溢银瓢	yu yu a mi zeng shou kao zi zhen lv xu yi yin piao	554
郁郁梁楝姿落落璠玙器	yu yu liang lian zi luo luo fan yu qi	841
雨竹图	yu zhu tu	606
缘何坐所添丁惨不住山中住洛中	yuan he zuo suo tian ding can bu zhu shan zhong zhu luo zhong	301
冤家宜解不宜结各自回头看后头	yuan jia yi jie bu yi jie ge zi hui tou kan hou tou	1199
愿教化作光明藏照彻黄泉不晓天	yuan jiao hua zuo guang ming cang zhao che huang quan bu xiao tian	1030
园林好	yuan lin hao	811
渊明图	yuan ming tu	487
愿随化雨之春泽未许云间一片心	yuan sui hua yu zhi chun ze wei xu yun jian yi pian xin	852
元镇江亭秋色图	yuan zhen jiang ting qiu se tu	509
愿祝一花添一岁年年长庆赏花时	yuan zhu yi hua tian yi sui nian nian chang qing shang hua shi	401
月分金影乱琼瑶	yue fen jin ying luan qiong yao	1254
乐府短歌行	yue fu duan ge xing	850
乐府相逢行	yue fu xiang feng xing	849
约阁江梅远近山一天风月绕柴关	yue ge jiang mei yuan jin shan yi tian feng yue rao chai guan	481
月昏潇湘烟水深为君一弄江南曲	yue hun xiao xiang yan shui shen wei jun yi nong jiang nan qu	281
月竞光华花竞姿	yue jing guang hua hua jing zi	944
月来高	yue lai gao	701
月临花径影交加	yue lin hua jing ying jiao jia	977
月笼花外影交枝	yue long hua wai ying jiao zhi	942
月落漫凭花送酒	yue luo man ping hua song jiu	999
月明花向灯前落春尽人从梦里逢	yue ming hua xiang deng qian luo chun jin ren cong meng li feng	1140
月明如水照花香	yue ming ru shui zhao hua xiang	966
月色花香处处同	yue se hua xiang chu chu tong	1010
月沈花谢事堪伤春树红颜梦短长	yue shen hua xie shi kan shang chun shu hong yan meng duan chang	1034
月思花情共一家	yue si hua qing gong yi jia	960
月台香榭两萧条	yue tai xiang xie liang xiao tiao	946
月为照花来院落	yue wei zhao hua lai yuan luo	959
月下花会我留酌	yue xia hua hui wo liu zhuo	1005
月下花开春寂寂	yue xia hua kai chun ji ji	991
月下几般花意思	yue xia ji ban hua yi si	1021
月中漫击催花鼓	yue zhong man ji cui hua gu	949
月中莫负赏花心	yue zhong mo fu shang hua xin	986
月转东墙花影重	yue zhuan dong qiang hua ying zhong	1017
云笼楚馆虚金屋凤入巫山奏玉箫	yun long chu guan xu jin wu feng ru wu shan zou yu xiao	1110
云破月窥花好处	yun po yue kui hua hao chu	1013
云散楚峰高凤去秦楼悄	yun san chu feng gao feng qu qin lou qiao	704
杂卉烂春色孤峰积雨痕	za hui lan chun se gu feng ji yu hen	325
在山清出山浊	zai shan qing chu shan zhuo	341
再托生来侬未老好教相见梦姿容	zai tuo sheng lai nong wei lao hao jiao xiang jian meng zi rong	1139
造化小儿凭杜撰冻凝块垒始丁东	zao hua xiao er ping du zhuan dong ning kuai lei shi ding dong	5
早起虚庭赋考盘稻田新纳十分宽	zao qi xu ting fu kao pan dao tian xin na shi fen kuan	792
泽中有山七十二夫椒最大居其一	ze zhong you shan qi shi er fu jiao zui da ju qi yi	332
赠日本友人彦九郎	zeng ri ben you ren yan jiu lang	1095
栈道连云势欲倾征人其奈旅魂惊	zhan dao lian yun shi yu qing zheng ren qi nai lv hun jing	534
栈道图	zhan dao tu	535
张梦晋改流水诗	zhang meng jin gai liu shui shi	1150
张梦晋图	zhang meng jin tu	580
昭君偏遇毛延寿炀帝难留张丽华	zhao jun pian yu mao yan shou yang di nan liu zhang li hua	899
这个女人不是人九天仙女下凡尘	zhe ge nv ren bu shi ren jiu tian xian nv xia fan chen	336
折花比对佳人面把臂相同觉命轻	zhe hua bi dui jia ren mian ba bi xiang tong jue ming qing	539
蔗浆满贮金瓯冷复有新蒸薄茸霜	zhe jiang man zhu jin ou leng fu you xin zheng bo rong shuang	684
折来对镜化红妆	zhe lai dui jing hua hong zhuang	1267
蛰燕还巢未定时村翁散社醉扶儿	zhe yan hai chao wei ding shi cun weng san she zui fu er	750
这衷肠事儿略略诉却落得眼睁睁	zhe zhong chang shi er lue lue su que luo de yan zheng zheng	427
真人受命整干枢失鹿狂秦不足诛	zhen ren shou ming zheng gan shu shi lu kuang qin bu zu zhu	478
震泽烟树图	zhen ze yan shu tu	334
征鸿图	zheng hong tu	411
只愁花月笑人痴	zhi chou hua yue xiao ren chi	978
只恐月沉花落后	zhi kong yue chen hua luo hou	947
只怕路阻蓝桥无由得见天	zhi pa lu zu lan qiao wu you de jian tian	696
只容逋客骑驴到不许朝官引骑来	zhi rong bu ke qi lv dao bu xu chao guan yin qi lai	116
枝上花开能几日世上人生能几何	zhi shang hua kai neng ji ri shi shang ren sheng neng ji he	1196
只为怜春色新红折一枚	zhi wei lian chun se xin hong zhe yi mei	190
芝鞋布蚁罢春游粉蝶黄蜂各自愁	zhi xie bu yi ba chun you fen die huang feng ge zi chou	762
直疑积雨得深润不假浮云相往还	zhi yi ji yu de shen run bu jia fu yun xiang wang huan	803
只有相思泪难剪旧痕才断接新痕	zhi you xiang si lei nan jian jiu hen cai duan jie xin hen	1039
只有绣床针线在残绒留得口脂香	zhi you xiu chuang zhen xian zai can rong liu de kou zhi xiang	1033
中间光阴不多时又有炎霜与烦恼	zhong jian guang yin bu duo shi you you yan shuang yu fan nao	926
中间有甚堪图画满坞桃花一醉人	zhong jian you shen kan tu hua man wu tao hua yi zui ren	66
昼耕夜读古人书青天仰面无惭色	zhou geng ye du gu ren shu qing tian yang mian wu can se	330
铸鼎铭钟封爵邑功名让与英雄立	zhu ding ming zhong feng jue yi gong ming rang yu ying xiong li	710
珠露未干啼络纬晓风初拂扬蛛丝	zhu lu wei gan ti luo wei xiao feng chu fu yang zhu si	398
朱门公子馔鲜鳞争诧金盘一尺银	zhu men gong zi zhuan xian lin zheng cha jin pan yi chi yin	284
主人持酒看漫饮吸清香	zhu ren chi jiu kan man yin xi qing xiang	203
主人莫拒看花客囊有青钱酒不赊	zhu ren mo ju kan hua ke nang you qing qian jiu bu she	150
注释	zhu shi	1216
竹图	zhu tu	550
竹枝图	zhu zhi tu	393
逐逐黄蜂粉蝶忙雕栏曲处见花王	zhu zhu huang feng fen die mang diao lan qu chu jian hua wang	250
壮心未肯逐樵渔秦运咸思备扫除	zhuang xin wei ken zhu qiao yu qin yun xian si bei sao chu	1161
壮心未宜逐樵渔泰运咸思备扫除	zhuang xin wei yi zhu qiao yu tai yun xian si bei sao chu	874
追思浮生真成梦到底终须有散场	zhui si fu sheng zhen cheng meng dao di zhong xu you san chang	907
准例公田多种秫不教诗与败催租	zhun li gong tian duo zhong shu bu jiao shi yu bai cui zu	224
自恨不才还自庆半生无事太平人	zi hen bu cai hai zi qing ban sheng wu shi tai ping ren	1105
自汲山泉烹凤饼坐临溪阁待幽人	zi ji shan quan peng feng bing zuo lin xi ge dai you ren	501
自今意思和谁说一片春心付海棠	zi jin yi si he shui shuo yi pian chun xin fu hai tang	234
自是节临三月暮何须人恨五更风	zi shi jie lin san yue mu he xu ren hen wu geng feng	1050
自是欲将花比貌凉风轻步野塘边	zi shi yu jiang hua bi mao liang feng qing bu ye tang bian	518
醉来举盏酹明月自谓此乐能通仙	zui lai ju zhan lei ming yue zi wei ci le neng tong xian	817
醉诗	zui shi	1082
最是含羞无那意故将结发试穿针	zui shi han xiu wu na yi gu jiang jie fa shi chuan zhen	260
最是诗人安稳处一编文字一炉香	zui shi shi ren an wen chu yi bian wen zi yi lu xiang	48
醉舞狂歌五十年花中行乐月中眠	zui wu kuang ge wu shi nian hua zhong xing le yue zhong mian	814
坐对黄花举一殇醒时还忆醉时狂	zuo dui huang hua ju yi shang xing shi hai yi zui shi kuang	910
坐看鸡虫笑庄子劳劳齐物物难齐	zuo kan ji chong xiao zhuang zi lao lao qi wu wu nan qi	129
昨日三山降除目长沮同拜地行仙	zuo ri san shan jiang chu mu chang ju tong bai di xing xian	527
昨日文园愁肺渴几丸嚼破蔗浆寒	zuo ri wen yuan chou fei ke ji wan jiao po zhe jiang han	394
做首评花咏月诗	zuo shou ping hua yong yue shi	980
昨夜隔墙花影动猛闻人语唤双文	zuo ye ge qiang hua ying dong meng wen ren yu huan shuang wen	382
昨夜海棠初着雨	zuo ye hai tang chu zhe yu	1270
昨夜海棠初着雨数朵轻盈娇欲语	zuo ye hai tang chu zhe yu shu duo qing ying jiao yu yu	1100
