# 文件名：五行篇.scel
# 词库名：五行篇
# 词库分类：中国哲学
# 词库描述：
# 词条样例：不悦不戚心悦而後能戚心所戚心 不敬不严严犹敬之责积者也 不尊不恭恭也者用上敬下也 不仁不安仁而能安天道也 不爱不仁爱而後仁
# 词条数量：28

不爱不仁爱而後仁	bu ai bu ren ai er hou ren	19
不间简不行行也者言其所行之	bu jian jian bu xing xing ye zhe yan qi suo xing zhi	18
不敬不严严犹敬之责积者也	bu jing bu yan yan you jing zhi ze ji zhe ye	16
不戚心不亲戚心而後能亲之	bu qi xin bu qin qi xin er hou neng qin zhi	21
不亲不爱亲而後能爱之	bu qin bu ai qin er hou neng ai zhi	20
不仁不安仁而能安天道也	bu ren bu an ren er neng an tian dao ye	12
不行不义义也	bu xing bu yi yi ye	17
不严不尊严而後忌己尊	bu yan bu zun yan er hou ji ji zun	15
不悦不戚心悦而後能戚心所戚心	bu yue bu qi xin yue er hou neng qi xin suo qi xin	22
不尊不恭恭也者用上敬下也	bu zun bu gong gong ye zhe yong shang jing xia ye	14
恭而後礼也有以体礼气也	gong er hou li ye you yi ti li qi ye	13
赫赫圣貌也言	he he sheng mao ye yan	8
经目侔而知之谓之进之	jing mu mou er zhi zhi wei zhi jin zhi	1
仁义心也同则善耳	ren yi xin ye tong ze shan er	2
圣人知天之道道者所道也	sheng ren zhi tian zhi dao dao zhe suo dao ye	7
士有志於君子道谓之志士	shi you zhi yu jun zi dao wei zhi zhi shi	28
诗曰不不救不刚不柔此之谓也	shi yue bu bu jiu bu gang bu rou ci zhi wei ye	4
是之谓独独也者舍体也	shi zhi wei du du ye zhe she ti ye	24
说不简不行间简也间简则行矣	shuo bu jian bu hang jian jian ye jian jian ze xing yi	3
说金声而玉振之	shuo jin sheng er yu zhen zhi	23
说尸鸟鸠在桑直之也	shuo shi niao jiu zai sang zhi zhi ye	25
四行之所和言和仁义也	si hang zhi suo he yan he ren yi ye	5
所安所行所敬人道也	suo an suo xing suo jing ren dao ye	6
形则圣圣	xing ze sheng sheng	26
以其中心与人交悦也壳壳	yi qi zhong xin yu ren jiao yue ye ke ke	11
玉音则圣形	yu yin ze sheng xing	27
远而庄之敬也敬者	yuan er zhuang zhi jing ye jing zhe	9
直而遂之也者遂直者也直者贵也	zhi er sui zhi ye zhe sui zhi zhe ye zhi zhe gui ye	10
