# 文件名：圣经.scel
# 词库名：圣经
# 词库分类：其他
# 词库描述：
# 词条样例：唯喜爱耶和华的律法 这人便为有福 凡他所作的 恶人必站立不住 并他的受膏者
# 词条数量：124

把床榻漂起	ba chuang ta piao qi	43
把褥子湿透	ba ru zi shi tou	42
必临到他自己的头上	bi lin dao ta zi ji de tou shang	4
并他的受膏者	bing ta de shou gao zhe	108
不站罪人的道路	bu zhan zui ren de dao lu	124
不坐怠慢人的座位	bu zuo dai man ren de zuo wei	123
臣宰一同商议	chen zai yi tong shang yi	110
大卫逃避他儿子押沙龙的时候作的诗	da wei tao bi ta er zi ya sha long de shi hou zuo de shi	87
大卫指着便雅悯人古实的话	da wei zhi zhe bian ya min ren gu shi de hua	34
但你耶和华是我四围的盾牌	dan ni ye he hua shi wo si wei de dun pai	82
当存畏惧事奉耶和华	dang cun wei ju shi feng ye he hua	92
当以嘴亲子	dang yi zui qin zi	90
抵挡我敌人的暴怒	di dang wo di ren de bao nu	22
都靠你欢欣	dou kao ni huan xin	53
恶人必站立不住	e ren bi zhan li bu zhu	116
凡他所作的	fan ta suo zuo de	118
歌颂耶和华至高者的名	ge song ye he hua zhi gao zhe de ming	1
好流人血弄诡诈的	hao liu ren xue nong gui zha de	61
将地极赐你为田产	jiang di ji ci ni wei tian chan	97
将我的性命踏在地下	jiang wo de xing ming ta zai di xia	25
将我救拔出来	jiang wo jiu ba chu lai	31
竟掉在自己所挖的阱里	jing diao zai zi ji suo wa de jing li	5
救恩属乎耶和华	jiu en shu hu ye he hua	75
就任凭仇敌追赶我	jiu ren ping chou di zhui gan wo	26
恐怕他们像狮子撕裂我	kong pa ta men xiang shi zi si lie wo	30
狂傲人不能站在你眼前	kuang ao ren bu neng zhan zai ni yan qian	62
连那无故与我为敌的	lian na wu gu yu wo wei di de	27
们要挣开他们的捆绑	men yao zheng kai ta men de kun bang	107
那时他要在怒中责备他们	na shi ta yao zai nu zhong ze bei ta men	103
那坐在天上的必发笑	na zuo zai tian shang de bi fa xiao	105
乃像糠毗被风吹散	nai xiang kang pi bei feng chui san	117
你必将他们如同窑匠的瓦器摔碎	ni bi jiang ta men ru tong yao jiang de wa qi shuai sui	95
你必用恩惠如同盾牌四面护卫他	ni bi yong en hui ru tong dun pai si mian hu wei ta	51
你必用铁杖打破他们	ni bi yong tie zhang da po ta men	96
你们便在道中灭亡	ni men bian zai dao zhong mie wang	89
你们将我的尊荣变为羞辱	ni men jiang wo de zun rong bian wei xiu ru	73
你们世上的审判官该受管教	ni men shi shang de shen pan guan gai shou guan jiao	93
你们要知道耶和华已经分别虔诚人归他自己	ni men yao zhi dao ye he hua yi jing fen bie qian cheng ren gui ta zi ji	72
你们一切作孽的人	ni men yi qie zuo nie de ren	39
你是我的儿子	ni shi wo de er zi	99
你要到几时才救我呢	ni yao dao ji shi cai jiu wo ne	47
你已经命定施行审判	ni yi jing ming ding shi xing shen pan	21
敲碎了恶人的牙齿	qiao sui le e ren de ya chi	76
求你不要在怒中责备我	qiu ni bu yao zai nu zhong ze bei wo	50
求你垂听我呼求的声音	qiu ni chui ting wo hu qiu de sheng yin	66
求你救我脱离一切追赶我的人	qiu ni jiu wo tuo li yi qie zhui gan wo de ren	32
求你留心听我的言语	qiu ni liu xin ting wo de yan yu	67
求你在怒中起来	qiu ni zai nu zhong qi lai	23
若有罪孽在我手里	ruo you zui nie zai wo shou li	29
神是公义的审判者	shen shi gong yi de shen pan zhe	12
神是我的盾牌	shen shi wo de dun pai	14
胜过那丰收五谷新酒的人	sheng guo na feng shou wu gu xin jiu de ren	69
试看恶人因奸恶而劬劳	shi kan e ren yin jian e er qu lao	8
使你的道路在我面前正直	shi ni de dao lu zai wo mian qian zheng zhi	58
世上的君王一齐起来	shi shang de jun wang yi qi qi lai	111
使我的荣耀归于灰尘	shi wo de rong yao gui yu hui chen	24
谁能指示我们什么好处	shui neng zhi shi wo men shen me hao chu	68
虽有成万的百姓来周围攻击我	sui you cheng wan de bai xing lai zhou wei gong ji wo	78
所怀的是毒害	suo huai de shi du hai	7
所生的是虚假	suo sheng de shi xu jia	6
他得不着神的帮助	ta de bu zhao shen de bang zhu	83
他的强暴必落到他自己的脑袋上	ta de qiang bao bi luo dao ta zi ji de nao dai shang	3
他就从他的圣山上应允我	ta jiu cong ta de sheng shan shang ying yun wo	79
他所射的是火箭	ta suo she de shi huo jian	9
他要像一棵树栽在溪水旁	ta yao xiang yi ke shu zai zai xi shui pang	120
他也预备了杀人的器械	ta ye yu bei le sha ren de qi xie	10
他拯救心里正直的人	ta zheng jiu xin li zheng zhi de ren	13
脱去他们的绳索	tuo qu ta men de sheng suo	106
外邦为什么争闹	wai bang wei shen me zheng nao	113
万民为什么谋算虚妄的事	wan min wei shen me mou suan xu wang de shi	112
唯喜爱耶和华的律法	wei xi ai ye he hua de lv fa	122
我必安然躺下睡觉	wo bi an ran tang xia shui jiao	71
我必存敬畏你的心向你的圣殿下拜	wo bi cun jing wei ni de xin xiang ni de sheng dian xia bai	59
我必凭你丰盛的慈爱进入你的居所	wo bi ping ni feng sheng de ci ai jin ru ni de ju suo	60
我的敌人何其加增	wo de di ren he qi jia zeng	86
我的一切仇敌都必羞愧	wo de yi qie chou di dou bi xiu kui	35
我就将列国赐你为基业	wo jiu jiang lie guo ci ni wei ji ye	98
我若以恶报那与我交好的人	wo ruo yi e bao na yu wo jiao hao de ren	28
我心也大大地惊惶	wo xin ye da da de jing huang	48
我要照着耶和华的公义称谢他	wo yao zhao zhe ye he hua de gong yi cheng xie ta	2
我已经立我的君在锡安我的圣山上了	wo yi jing li wo de jun zai xi an wo de sheng shan shang le	101
我因唉哼而困乏	wo yin ai heng er kun fa	44
我因忧愁眼睛干瘪	wo yin you chou yan jing gan bie	41
我用我的声音求告耶和华	wo yong wo de sheng yin qiu gao ye he hua	80
现在你们君王应当省悟	xian zai ni men jun wang ying dang xing wu	94
向耶和华唱的流离歌	xiang ye he hua chang de liu li ge	33
要敌挡耶和华	yao di dang ye he hua	109
也不要在烈怒中惩罚我	ye bu yao zai lie nu zhong cheng fa wo	49
耶和华必收纳我的祷告	ye he hua bi shou na wo de dao gao	36
耶和华曾对我说	ye he hua ceng dui wo shuo	100
耶和华听了我的恳求	ye he hua ting le wo de ken qiu	37
耶和华向众民施行审判	ye he hua xiang zhong min shi xing shen pan	18
叶子也不枯干	ye zi ye bu ku gan	119
因为独有你耶和华使我安然居住	yin wei du you ni ye he hua shi wo an ran ju zhu	70
因为公义的神察验人的心肠肺腑	yin wei gong yi de shen cha yan ren de xin chang fei fu	15
因为你必赐福与义人	yin wei ni bi ci fu yu yi ren	52
因为你不是喜悦恶事的神	yin wei ni bu shi xi yue e shi de shen	63
因为你打了我一切仇敌的腮骨	yin wei ni da le wo yi qie chou di de sai gu	77
因为他的怒气快要发作	yin wei ta de nu qi kuai yao fa zuo	88
因为他们的口中没有诚实	yin wei ta men de kou zhong mei you cheng shi	57
因为耶和华听了我哀哭的声音	yin wei ye he hua ting le wo ai ku de sheng yin	38
因为耶和华知道义人的道路	yin wei ye he hua zhi dao yi ren de dao lu	114
因为在死地无人记念你	yin wei zai si di wu ren ji nian ni	46
又当存战兢而快乐	you dang cun zhan jing er kuai le	91
又是叫我抬起头来的	you shi jiao wo tai qi tou lai de	81
又是天天向恶人发怒的神	you shi tian tian xiang e ren fa nu de shen	11
有许多人起来攻击我	you xu duo ren qi lai gong ji wo	85
有许多人议论我说	you xu duo ren yi lun wo shuo	84
又因我一切的敌人眼睛昏花	you yin wo yi qie de di ren yan jing hun hua	40
又愿那爱你名的人	you yuan na ai ni ming de ren	54
愿恶人的恶断绝	yuan e ren de e duan jue	17
愿你赐福给你的百姓	yuan ni ci fu gei ni de bai xing	74
愿你从其上归于高位	yuan ni cong qi shang gui yu gao wei	19
愿你坚立义人	yuan ni jian li yi ren	16
愿你在他们许多的过犯中	yuan ni zai ta men xu duo de guo fan zhong	55
愿他们因自己的计谋跌倒	yuan ta men yin zi ji de ji mou die dao	56
愿众民的会环绕你	yuan zhong min de hui huan rao ni	20
在烈怒中惊吓他们	zai lie nu zhong jing xia ta men	102
在阴间有谁称谢你	zai yin jian you shui cheng xie ni	45
早晨你必听我的声音	zao chen ni bi ting wo de sheng yin	65
早晨我必向你陈明我的心意	zao chen wo bi xiang ni chen ming wo de xin yi	64
这人便为有福	zhe ren bian wei you fu	121
主必嗤笑他们	zhu bi chi xiao ta men	104
罪人在义人的会中	zui ren zai yi ren de hui zhong	115
