# 文件名：大六壬毕法赋全文.scel
# 词库名：大六壬毕法赋全文
# 词库分类：中国哲学
# 词库描述：
# 词条样例：前后引从升迁吉 帘幕贵人高甲第 催官使者赴官期 六阳数足须公用 六阴相继尽昏迷 进茹空亡宜退步
# 词条数量：100

彼此猜忌害相随	bi ci cai ji hai xiang sui	25
彼此全伤防两损	bi ci quan shang fang liang sun	38
闭口卦体两般推	bi kou gua ti liang ban tui	63
避难逃生须弃旧	bi nan tao sheng xu qi jiu	92
彼求我事支传干	bi qiu wo shi zhi chuan gan	78
宾主不投刑在上	bin zhu bu tou xing zai shang	26
病符克宅全家患	bing fu ke zhai quan jia huan	30
不行传者考初时	bu xing chuan zhe kao chu shi	19
常问不应逢吉象	chang wen bu ying feng ji xiang	2
初遭夹克不由己	chu zao jia ke bu you ji	16
传财化鬼财休觅	chuan cai hua gui cai xiu mi	74
传财太旺反财亏	chuan cai tai wang fan cai kui	87
传鬼化财钱险危	chuan gui hua cai qian xian wei	73
传墓入墓分憎爱	chuan mu ru mu fen zeng ai	20
催官使者赴官期	cui guan shi zhe fu guan qi	97
二贵皆空虚喜期	er gui jie kong xu xi qi	51
费有余而得不足	fei you yu er de bu zu	44
非占现类勿言之	fei zhan xian lei wu yan zhi	3
夫妇芜淫各有私	fu fu wu yin ge you si	37
富贵干支逢禄马	fu gui gan zhi feng lu ma	60
干乘墓虎无占病	gan cheng mu hu wu zhan bing	40
干墓并关人宅废	gan mu bing guan ren zhai fei	36
干支乘墓各昏迷	gan zhi cheng mu ge hun mi	13
干支皆败势倾颓	gan zhi jie bai shi qing tui	65
干支值绝凡谋决	gan zhi zhi jue fan mou jue	22
罡塞鬼户任谋为	gang sai gui hu ren mou wei	49
鬼乘天乙乃神祗	gui cheng tian yi nai shen zhi	53
鬼临三四讼灾随	gui lin san si song zai sui	31
贵人差迭事参差	gui ren cha die shi cen ci	55
贵虽在狱宜临干	gui sui zai yu yi lin gan	54
鬼贼当时无畏忌	gui zei dang shi wu wei ji	88
害贵讼直作屈断	hai gui song zhi zuo qu duan	58
合中犯杀蜜中砒	he zhong fan sha mi zhong pi	17
后合占婚岂用媒	hou he zhan hun qi yong mei	61
虎乘遁鬼殃非浅	hu cheng dun gui yang fei qian	32
虎临干鬼凶速速	hu lin gan gui xiong su su	10
互生俱生凡事益	hu sheng ju sheng fan shi yi	24
虎视逢虎力难施	hu shi feng hu li nan shi	47
虎受克神为病症	hu shou ke shen wei bing zheng	34
互旺皆旺坐谋宜	hu wang jie wang zuo mou yi	23
华盖覆日人昏晦	hua gai fu ri ren hun hui	42
将逢内战所谋危	jiang feng nei zhan suo mou wei	15
交车相合交关利	jiao che xiang he jiao guan li	80
脚踏空亡进用宜	jiao ta kong wang jin yong yi	83
金日逢丁凶祸动	jin ri feng ding xiong huo dong	76
进茹空亡宜退步	jin ru kong wang yi tui bu	84
眷属丰盈居狭窄	juan shu feng ying ju xia zhai	72
课传俱贵转无依	ke chuan ju gui zhuan wu yi	57
空空如也事休追	kong kong ru ye shi xiu zhui	27
空上乘空事莫追	kong shang cheng kong shi mo zhui	85
苦去甘来乐里悲	ku qu gan lai le li bei	67
魁度天门关隔定	kui du tian men guan ge ding	50
来去俱空岂动宜	lai qu ju kong qi dong yi	11
帘幕贵人高甲第	lian mu gui ren gao jia di	98
两贵受克虽干贵	liang gui shou ke sui gan gui	52
两蛇夹墓凶难免	liang she jia mu xiong nan mian	48
六阳数足须公用	liu yang shu zu xu gong yong	96
六爻现卦防其克	liu yao xian gua fang qi ke	6
六阴相继尽昏迷	liu yin xiang ji jin hun mi	95
龙加生气吉迟迟	long jia sheng qi ji chi chi	9
末助初兮三等论	mo zhu chu xi san deng lun	64
前后逼迫难进退	qian hou bi po nan jin tui	28
前后引从升迁吉	qian hou yin cong sheng qian ji	100
权摄不正禄临支	quan she bu zheng lu lin zhi	93
任信丁马须言动	ren xin ding ma xu yan dong	12
人宅皆死各衰赢	ren zhai jie si ge shuai ying	21
人宅受脱俱招盗	ren zhai shou tuo ju zhao dao	66
人宅坐墓甘招晦	ren zhai zuo mu gan zhao hui	14
三传递生人举荐	san chuan di sheng ren ju jian	70
三传互克众人欺	san chuan hu ke zhong ren qi	69
丧吊全逢挂缟衣	sang diao quan feng gua gao yi	29
上下皆合两心齐	shang xia jie he liang xin qi	79
首尾相见始终宜	shou wei xiang jian shi zhong yi	99
水日逢丁财动之	shui ri feng ding cai dong zhi	75
虽忧狐假虎威仪	sui you hu jia hu wei yi	89
所谋多拙逢罗网	suo mou duo zhuo feng luo wang	46
所筮不入仍凭类	suo shi bu ru reng ping lei	4
胎财死无损胎推	tai cai si wu sun tai tui	81
胎神生气妻怀孕	tai shen sheng qi qi huai yun	82
太阳射宅屋光辉	tai yang she zhai wu guang hui	41
太阳照武宜擒贼	tai yang zhao wu yi qin zei	62
天网自裹己招灾	tian wang zi guo ji zhao zai	45
脱上逢脱防虚诈	tuo shang feng tuo fang xu zha	86
万事喜忻三六合	wan shi xi xin san lu he	18
旺禄临身徒妄作	wang lu lin shen tu wang zuo	94
妄用三传灾祸异	wang yong san chuan zai huo yi	8
我求彼事干传支	wo qiu bi shi gan chuan zhi	77
屋宇宽广致人衰	wu yu kuan guang zhi ren shuai	71
喜惧空亡乃妙机	xi ju kong wang nai miao ji	7
朽木难雕别作为	xiu mu nan diao bie zuo wei	91
旬内空亡逐类推	xun nei kong wang zhu lei tui	5
已灾凶逃返无疑	yi zai xiong tao fan wu yi	1
用破身心无所依	yong po shen xin wu suo yi	43
有始无终难变易	you shi wu zhong nan bian yi	68
支乘墓虎有伏尸	zhi cheng mu hu you fu shi	39
支坟财并旅程稽	zhi fen cai bing lv cheng ji	35
制鬼之位乃良医	zhi gui zhi wei nai liang yi	33
众鬼虽彰全不畏	zhong gui sui zhang quan bu wei	90
昼夜贵加求两贵	zhou ye gui jia qiu liang gui	56
尊崇传内遇三奇	zun chong chuan nei yu san qi	59
