# 文件名：正觉总持咒.scel
# 词库名：正觉总持咒
# 词库分类：佛教
# 词库描述：
# 词条样例：与此相应故 二所现影故 三位差别故 四所显示故 具足解脱道 及佛菩提道
# 词条数量：14

般若道种智	bo re dao zhong zhi	12
二所现影故	er suo xian ying gu	8
函盖一切法	han gai yi qie fa	11
及佛菩提道	ji fo pu ti dao	3
具足解脱道	ju zu jie tuo dao	4
涅槃如来藏	nie pan ru lai zang	13
求正觉佛子	qiu zheng jue fo zi	2
如是次第现	ru shi ci di xian	5
三位差别故	san wei cha bie gu	7
四所显示故	si suo xian shi gu	6
五阴十八界	wu yin shi ba jie	14
一切应受持	yi qie ying shou chi	1
一切最胜故	yi qie zui sheng gu	10
与此相应故	yu ci xiang ying gu	9
