# 文件名：谁是最可爱的人.scel
# 词库名：谁是最可爱的人
# 词库分类：其它
# 词库描述：
# 词条样例：我们的战士 看不出他们有丰盛细致的感情 在放纵奔流着 谁是我们最可爱的人呢 你说的就是那些兵吗
# 词条数量：74

把敌人抱得那样紧	ba di ren bao de na yang jin	5
把敌人捺倒在地上的	ba di ren na dao zai di shang de	18
把他们的身上烧着了火	ba ta men de shen shang shao zhao le huo	26
把他们压到山脚	ba ta men ya dao shan jiao	28
但他们却打死了三百多敌人	dan ta men que da si le san bai duo di ren	1
弹体上沾满脑浆	dan ti shang zhan man nao jiang	13
但我最急于告诉你们的	dan wo zui ji yu gao su ni men de	68
但勇士们在这烟与火的山岗上	dan yong shi men zai zhe yan yu huo de shan gang shang	37
当他们赶到书堂站时	dang ta men gan dao shu tang zhan shi	45
敌人为了逃命	di ren wei le tao ming	41
都告诉给我祖国的朋友们	dou gao su gei wo zu guo de peng you men	69
飞机掷下的汽油弹	fei ji zhi xia de qi you dan	27
分都分不开	fen dou fen bu kai	4
蜂涌上来的敌人	feng yong shang lai de di ren	30
高喊着口号	gao han zhe kou hao	36
还是在二次战役的时候	hai shi zai er ci zhan yi de shi hou	48
还有一个战士	hai you yi ge zhan shi	15
好使自己的主力不致覆灭	hao shi zi ji de zhu li bu zhi fu mie	33
和敌人倒在一起	he di ren dao zai yi qi	17
和他死在一起的美国鬼子	he ta si zai yi qi de mei guo gui zi	12
很简单的哩	hen jian dan de li	58
既看不出他们有什么高明的知识	ji kan bu chu ta men you shen me gao ming de zhi shi	57
机枪零件扔得满山都是	ji qiang ling jian reng de man shan dou shi	24
据这个营的营长告诉我	ju zhe ge ying de ying zhang gao su wo	25
看不出他们有丰盛细致的感情	kan bu chu ta men you feng sheng xi zhi de gan qing	56
可是敌人还是要拼死争夺	ke shi di ren hai shi yao pin si zheng duo	34
可是我要说	ke shi wo yao shuo	55
烈士们的尸体	lie shi men de shi ti	23
另有一个战士	ling you yi ge zhan shi	9
脑浆崩裂	nao jiang beng lie	11
你说的就是那些兵吗	ni shuo de jiu shi na xie bing ma	60
汽油弹的火焰把这个阵地烧红了	qi you dan de huo yan ba zhe ge zhen di shao hong le	38
去切断军隅里敌人的逃路	qu qie duan jun yu li di ren de tao lu	46
让我还是来说一段故事吧	rang wo hai shi lai shuo yi duan gu shi ba	49
烧在一起	shao zai yi qi	16
是我思想感情的一段重要经历	shi wo si xiang gan qing de yi duan zhong yao jing li	67
谁是我们最可爱的人呢	shui shi wo men zui ke ai de ren ne	65
他的嘴里还衔着敌人的半块耳朵	ta de zui li hai xian zhe di ren de ban kuai er duo	8
他们的品质是那样的纯洁和高尚	ta men de pin zhi shi na yang de chun jie he gao shang	53
他们的气质是那样的淳朴和谦逊	ta men de qi zhi shi na yang de chun pu he qian xun	51
他们的胸怀是那样的美丽和宽广	ta men de xiong huai shi na yang de mei li he kuan guang	50
他们的意志是那样的坚韧和刚强	ta men de yi zhi shi na yang de jian ren he gang qiang	52
他们看来是很平凡	ta men kan lai shi hen ping fan	59
它使我想把一切东西	ta shi wo xiang ba yi qie dong xi	70
他手里还紧握着一个手榴弹	ta shou li hai jin wo zhe yi ge shou liu dan	14
逃敌也恰恰赶到那里	tao di ye qia qia gan dao na li	44
涂了一地	tu le yi di	10
我的思想感情的潮水	wo de si xiang gan qing de chao shui	72
我都被一些东西感动着	wo dou bei yi xie dong xi gan dong zhe	73
我感觉他们是最可爱的人	wo gan jue ta men shi zui ke ai de ren	62
我们的部队	wo men de bu dui	64
我们的战士	wo men de zhan shi	63
血也把这山岗流红了	xue ye ba zhe shan gang liu hong le	35
眼看就要从汽车路上开过去	yan kan jiu yao cong qi che lu shang kai guo qu	43
也许有的人在心里隐隐约约地说	ye xu you de ren zai xin li yin yin yue yue de shuo	61
一场壮烈的搏斗就开始了	yi chang zhuang lie de bo dou jiu kai shi le	42
以致把有的手指都折断了	yi zhi ba you de shou zhi dou zhe duan le	3
因此你没有能够了解到	yin ci ni mei you neng gou liao jie dao	54
用三十二架飞机	yong san shi er jia fei ji	40
有抱住敌人头的	you bao zhu di ren tou de	20
有抱住敌人腰的	you bao zhu di ren yao de	21
有卡住敌人脖子	you qia zhu di ren bo zi	19
有一支志愿军的部队向敌后猛插	you yi zhi zhi yuan jun de bu dui xiang di hou meng cha	47
由于他们两手扣着	you yu ta men liang shou kou zhe	6
在朝鲜的每一天	zai chao xian de mei yi tian	74
在放纵奔流着	zai fang zong ben liu zhe	71
在掩埋烈士们遗体的时候	zai yan mai lie shi men yi ti de shi hou	7
占领了山头	zhan ling le shan tou	29
这个连虽然伤亡很大	zhe ge lian sui ran shang wang hen da	2
这激战整整持续了八个小时	zhe ji zhan zheng zheng chi xu le ba ge xiao shi	32
这就是	zhe jiu shi	66
整个山顶都被打翻了	zheng ge shan ding dou bei da fan le	39
最后勇士们的子弹打光了	zui hou yong shi men de zi dan da guang le	31
做着各种各样的姿势	zuo zhe ge zhong ge yang de zi shi	22
